省份,日期,新增确诊,新增治愈,新增死亡,累计确诊人数,累计治愈人数,累计死亡人数
湖北,2020-01-10,41,2,1,41,2,1
湖北,2020-01-11,0,4,0,41,6,1
湖北,2020-01-12,0,1,0,41,7,1
湖北,2020-01-15,0,5,1,41,12,2
湖北,2020-01-16,4,3,0,45,15,2
湖北,2020-01-17,17,4,0,62,19,2
湖北,2020-01-18,59,5,1,121,24,3
湖北,2020-01-19,77,1,1,198,25,4
湖北,2020-01-20,60,0,2,258,25,6
湖北,2020-01-21,105,3,3,363,28,9
湖北,2020-01-22,62,0,8,425,28,17
湖北,2020-01-23,70,3,6,495,31,23
湖北,2020-01-24,77,1,15,572,32,38
湖北,2020-01-25,46,8,7,618,40,45
湖北,2020-01-26,80,2,18,698,42,63
湖北,2020-01-27,892,0,22,1590,42,85
湖北,2020-01-28,315,0,19,1905,42,104
湖北,2020-01-29,356,7,25,2261,49,129
湖北,2020-01-30,378,21,30,2639,70,159
湖北,2020-01-31,576,36,33,3215,106,192
湖北,2020-02-01,894,32,32,4109,138,224
湖北,2020-02-02,1033,53,41,5142,191,265
湖北,2020-02-03,1242,79,48,6384,270,313
湖北,2020-02-04,1967,65,49,8351,335,362
湖北,2020-02-05,1766,63,52,10117,398,414
湖北,2020-02-06,1501,103,64,11618,501,478
湖北,2020-02-07,1985,164,67,13603,665,545
湖北,2020-02-08,1379,179,63,14982,844,608
湖北,2020-02-09,1920,167,73,16902,1011,681
湖北,2020-02-10,1552,162,67,18454,1173,748
湖北,2020-02-11,1104,171,72,19558,1344,820
湖北,2020-02-12,12523,538,108,32081,1882,928
湖北,2020-02-13,3910,370,88,35991,2252,1016
湖北,2020-02-14,1923,486,107,37914,2738,1123
湖北,2020-02-15,1548,413,110,39462,3151,1233
湖北,2020-02-16,1690,543,76,41152,3694,1309
湖北,2020-02-17,1600,761,72,42752,4455,1381
湖北,2020-02-18,1660,676,116,44412,5131,1497
湖北,2020-02-19,640,553,88,45052,5684,1585
湖北,2020-02-20,319,766,99,45371,6450,1684
湖北,2020-02-21,315,992,90,45686,7442,1774
湖北,2020-02-22,573,965,82,46259,8407,1856
湖北,2020-02-23,348,772,131,46607,9179,1987
湖北,2020-02-24,464,1391,56,47071,10570,2043
湖北,2020-02-25,370,1456,42,47441,12026,2085
湖北,2020-02-26,383,1535,19,47824,13561,2104
湖北,2020-02-27,313,2498,28,48137,16059,2132
湖北,2020-02-28,420,1726,37,48557,17785,2169
湖北,2020-02-29,565,1675,26,49122,19460,2195
湖北,2020-03-01,193,1958,32,49315,21418,2227
湖北,2020-03-02,111,1846,24,49426,23264,2251
湖北,2020-03-03,114,1859,31,49540,25123,2282
湖北,2020-03-04,131,1426,23,49671,26549,2305
湖北,2020-03-05,126,1038,23,49797,27587,2328
湖北,2020-03-06,74,1157,21,49871,28744,2349
湖北,2020-03-07,41,1259,21,49912,30003,2370
湖北,2020-03-08,36,1163,18,49948,31166,2388
湖北,2020-03-09,17,896,16,49965,32062,2404
湖北,2020-03-10,13,1202,19,49978,33264,2423
湖北,2020-03-11,8,1053,7,49986,34317,2430
湖北,2020-03-12,5,1103,6,49991,35420,2436
湖北,2020-03-13,4,1254,10,49995,36674,2446
湖北,2020-03-14,4,1111,10,49999,37785,2456
湖北,2020-03-15,4,752,13,50003,38537,2469
湖北,2020-03-16,1,836,11,50004,39373,2480
湖北,2020-03-17,1,800,10,50005,40173,2490
湖北,2020-03-18,0,713,6,50005,40886,2496
湖北,2020-03-19,0,620,2,50005,41506,2498
湖北,2020-03-20,0,502,6,50005,42008,2504
湖北,2020-03-21,0,463,4,50005,42471,2508
湖北,2020-03-22,0,434,9,50005,42905,2517
湖北,2020-03-23,1,426,7,50006,43331,2524
湖北,2020-03-24,0,372,2,50006,43703,2526
湖北,2020-03-25,0,317,5,50006,44020,2531
湖北,2020-03-26,0,523,4,50006,44543,2535
湖北,2020-03-27,0,260,3,50006,44803,2538
湖北,2020-03-28,0,367,5,50006,45170,2543
湖北,2020-03-29,0,215,4,50006,45385,2547
湖北,2020-03-30,0,169,1,50006,45554,2548
湖北,2020-03-31,1,73,5,50007,45627,2553
湖北,2020-04-01,0,45,6,50007,45672,2559
湖北,2020-04-02,0,41,4,50007,45713,2563
湖北,2020-04-03,1,50,4,50008,45763,2567
湖北,2020-04-04,0,73,3,50008,45836,2570
湖北,2020-04-05,0,69,1,50008,45905,2571
湖北,2020-04-06,0,59,0,50008,45964,2571
湖北,2020-04-07,0,69,1,50008,46033,2572
湖北,2020-04-08,0,45,2,50008,46078,2574
湖北,2020-04-09,0,49,1,50008,46127,2575
湖北,2020-04-10,0,27,2,50008,46154,2577
湖北,2020-04-11,0,17,0,50008,46171,2577
湖北,2020-04-12,0,57,2,50008,46228,2579
湖北,2020-04-13,0,25,0,50008,46253,2579
湖北,2020-04-14,0,39,0,50008,46292,2579
湖北,2020-04-15,0,33,0,50008,46325,2579
湖北,2020-04-16,325,10,1290,50333,46335,3869
湖北,2020-04-17,0,7,0,50333,46342,3869
湖北,2020-04-18,0,13,0,50333,46355,3869
湖北,2020-04-19,0,4,0,50333,46359,3869
湖北,2020-04-20,0,3,0,50333,46362,3869
湖北,2020-04-21,0,5,0,50333,46367,3869
湖北,2020-04-22,0,28,0,50333,46395,3869
湖北,2020-04-23,0,22,0,50333,46417,3869
湖北,2020-04-24,0,24,0,50333,46441,3869
湖北,2020-04-25,0,11,0,50333,46452,3869
湖北,2020-04-26,0,12,0,50333,46464,3869
湖北,2020-05-09,1,0,0,50334,46464,3869
湖北,2020-05-10,5,0,0,50339,46464,3869
湖北,2020-05-18,1,0,0,50340,46464,3869
湖北,2020-05-24,0,1,0,50340,46465,3869
湖北,2020-05-26,0,1,0,50340,46466,3869
湖北,2020-05-29,0,1,0,50340,46467,3869
湖北,2020-05-31,0,1,0,50340,46468,3869
湖北,2020-06-04,0,3,0,50340,46471,3869
北京,2020-01-19,2,0,0,2,0,0
北京,2020-01-24,0,1,0,2,1,0
北京,2020-01-25,0,1,0,2,2,0
北京,2020-01-26,3,0,0,5,2,0
北京,2020-01-27,2,0,0,7,2,0
北京,2020-01-28,3,0,0,10,2,0
北京,2020-01-30,6,0,0,16,2,0
北京,2020-01-31,3,0,0,19,2,0
北京,2020-02-01,2,0,0,21,2,0
北京,2020-02-02,7,0,0,28,2,0
北京,2020-02-03,1,0,0,29,2,0
北京,2020-02-05,3,0,0,32,2,0
北京,2020-02-06,2,0,0,34,2,0
北京,2020-02-08,1,0,0,35,2,0
北京,2020-02-09,1,0,0,36,2,0
北京,2020-02-11,1,0,0,37,2,0
北京,2020-02-12,1,0,0,38,2,0
北京,2020-02-13,1,0,0,39,2,0
北京,2020-06-13,4,0,0,43,2,0
北京,2020-06-14,7,0,0,50,2,0
北京,2020-06-15,1,0,0,51,2,0
北京,2020-06-16,5,0,0,56,2,0
北京,2020-06-17,6,0,0,62,2,0
北京,2020-06-18,5,0,0,67,2,0
北京,2020-06-19,8,0,0,75,2,0
北京,2020-06-20,8,0,0,83,2,0
北京,2020-06-22,3,0,0,86,2,0
北京,2020-06-23,1,0,0,87,2,0
北京,2020-06-24,4,0,0,91,2,0
北京,2020-06-25,1,0,0,92,2,0
北京,2020-06-26,2,0,0,94,2,0
北京,2020-06-27,4,0,0,98,2,0
北京,2020-06-28,2,0,0,100,2,0
北京,2020-06-29,1,0,0,101,2,0
北京,2020-06-30,3,0,0,104,2,0
广东,2020-01-19,1,0,0,1,0,0
广东,2020-01-20,8,0,0,9,0,0
广东,2020-01-21,5,0,0,14,0,0
广东,2020-01-22,1,0,0,15,0,0
广东,2020-01-23,0,2,0,15,2,0
广东,2020-01-24,5,0,0,20,2,0
广东,2020-01-25,7,0,0,27,2,0
广东,2020-01-26,9,0,0,36,2,0
广东,2020-01-27,13,2,0,49,4,0
广东,2020-01-28,14,0,0,63,4,0
广东,2020-01-29,23,0,0,86,4,0
广东,2020-01-30,24,0,0,110,4,0
广东,2020-01-31,60,0,0,170,4,0
广东,2020-02-01,26,1,0,196,5,0
广东,2020-02-02,30,0,0,226,5,0
广东,2020-02-03,43,5,0,269,10,0
广东,2020-02-04,20,3,0,289,13,0
广东,2020-02-05,25,3,0,314,16,0
广东,2020-02-06,20,6,0,334,22,0
广东,2020-02-07,17,9,0,351,31,0
广东,2020-02-08,13,8,0,364,39,0
广东,2020-02-09,4,7,0,368,46,0
广东,2020-02-10,7,10,0,375,56,0
广东,2020-02-11,11,10,0,386,66,0
广东,2020-02-12,5,15,0,391,81,0
广东,2020-02-13,9,13,0,400,94,0
广东,2020-02-14,6,10,0,406,104,0
广东,2020-02-15,8,11,0,414,115,0
广东,2020-02-16,1,16,2,415,131,2
广东,2020-02-17,1,21,0,416,152,2
广东,2020-02-18,0,11,0,416,163,2
广东,2020-02-19,0,19,0,416,182,2
广东,2020-02-20,0,17,0,416,199,2
广东,2020-02-21,1,23,0,417,222,2
广东,2020-02-22,0,4,1,417,226,3
广东,2020-02-23,0,11,0,417,237,3
广东,2020-02-24,0,12,0,417,249,3
广东,2020-02-25,0,13,0,417,262,3
广东,2020-02-26,0,9,0,417,271,3
广东,2020-02-27,0,10,0,417,281,3
广东,2020-03-01,0,39,0,417,320,3
广东,2020-03-02,0,12,0,417,332,3
广东,2020-03-03,0,9,0,417,341,3
广东,2020-03-05,0,17,0,417,358,3
广东,2020-03-07,0,10,0,417,368,3
广东,2020-03-08,0,5,0,417,373,3
广东,2020-03-09,0,8,0,417,381,3
广东,2020-03-10,0,6,0,417,387,3
广东,2020-03-11,0,5,0,417,392,3
广东,2020-03-13,0,3,0,417,395,3
广东,2020-03-14,0,1,0,417,396,3
广东,2020-03-15,0,5,0,417,401,3
广东,2020-03-17,0,2,0,417,403,3
广东,2020-03-18,0,4,0,417,407,3
广东,2020-03-20,0,3,0,417,410,3
广东,2020-03-22,0,1,0,417,411,3
广东,2020-03-23,0,3,0,417,414,3
广东,2020-03-31,1,0,0,418,414,3
广东,2020-04-05,1,0,0,419,414,3
广东,2020-04-16,1,0,0,420,414,3
广东,2020-04-17,1,0,0,421,414,3
广东,2020-04-18,1,0,0,422,414,3
广东,2020-04-28,1,0,0,423,414,3
北京,2020-01-20,2,0,0,2,0,0
北京,2020-01-24,1,0,0,3,0,0
北京,2020-01-25,2,0,0,5,0,0
北京,2020-01-26,2,0,0,7,0,0
北京,2020-01-28,1,0,0,8,0,0
北京,2020-01-29,1,0,0,9,0,0
北京,2020-01-30,3,0,0,12,0,0
北京,2020-02-02,1,0,0,13,0,0
北京,2020-02-03,1,0,0,14,0,0
北京,2020-02-04,1,0,0,15,0,0
北京,2020-02-06,2,0,0,17,0,0
北京,2020-02-09,1,0,0,18,0,0
北京,2020-02-10,1,0,0,19,0,0
北京,2020-02-12,5,0,0,24,0,0
北京,2020-02-15,1,0,0,25,0,0
北京,2020-02-17,4,0,0,29,0,0
北京,2020-06-25,1,0,0,30,0,0
浙江,2020-01-20,1,0,0,1,0,0
浙江,2020-01-22,5,0,0,6,0,0
浙江,2020-01-24,6,0,0,12,0,0
浙江,2020-01-25,15,0,0,27,0,0
浙江,2020-01-27,5,0,0,32,0,0
浙江,2020-01-28,19,0,0,51,0,0
浙江,2020-01-29,18,0,0,69,0,0
浙江,2020-01-30,16,0,0,85,0,0
浙江,2020-01-31,13,0,0,98,0,0
浙江,2020-02-01,12,2,0,110,2,0
浙江,2020-02-02,8,0,0,118,2,0
浙江,2020-02-03,13,4,0,131,6,0
浙江,2020-02-04,9,1,0,140,7,0
浙江,2020-02-05,5,8,0,145,15,0
浙江,2020-02-06,5,1,0,150,16,0
浙江,2020-02-07,3,6,0,153,22,0
浙江,2020-02-08,1,7,0,154,29,0
浙江,2020-02-09,1,12,0,155,41,0
浙江,2020-02-10,2,7,0,157,48,0
浙江,2020-02-11,2,3,0,159,51,0
浙江,2020-02-12,3,12,0,162,63,0
浙江,2020-02-13,3,6,0,165,69,0
浙江,2020-02-14,1,4,0,166,73,0
浙江,2020-02-15,0,2,0,166,75,0
浙江,2020-02-16,2,6,0,168,81,0
浙江,2020-02-17,0,13,0,168,94,0
浙江,2020-02-18,0,4,0,168,98,0
浙江,2020-02-19,1,10,0,169,108,0
浙江,2020-02-20,0,3,0,169,111,0
浙江,2020-02-21,0,10,0,169,121,0
浙江,2020-02-22,0,2,0,169,123,0
浙江,2020-02-23,0,8,0,169,131,0
浙江,2020-02-24,0,5,0,169,136,0
浙江,2020-02-25,0,3,0,169,139,0
浙江,2020-02-26,0,6,0,169,145,0
浙江,2020-02-27,0,6,0,169,151,0
浙江,2020-02-28,0,8,0,169,159,0
浙江,2020-02-29,0,5,0,169,164,0
浙江,2020-03-01,0,1,0,169,165,0
浙江,2020-03-02,5,0,0,174,165,0
浙江,2020-03-04,0,4,0,174,169,0
浙江,2020-03-05,0,1,0,174,170,0
浙江,2020-03-08,0,3,0,174,173,0
浙江,2020-03-10,0,1,0,174,174,0
浙江,2020-03-13,12,0,0,186,174,0
浙江,2020-03-15,0,2,0,186,176,0
湖北,2020-01-20,12,0,0,12,0,0
湖北,2020-01-24,52,0,0,64,0,0
湖北,2020-01-25,58,2,2,122,2,2
湖北,2020-01-26,32,0,2,154,2,4
湖北,2020-01-27,59,2,0,213,4,4
湖北,2020-01-28,111,0,1,324,4,5
湖北,2020-01-29,172,3,7,496,7,12
湖北,2020-01-30,77,1,0,573,8,12
湖北,2020-01-31,153,11,2,726,19,14
湖北,2020-02-01,276,10,1,1002,29,15
湖北,2020-02-02,244,5,2,1246,34,17
湖北,2020-02-03,176,9,2,1422,43,19
湖北,2020-02-04,223,11,6,1645,54,25
湖北,2020-02-05,162,10,4,1807,64,29
湖北,2020-02-06,90,6,3,1897,70,32
湖北,2020-02-07,144,37,4,2041,107,36
湖北,2020-02-08,100,32,7,2141,139,43
湖北,2020-02-09,111,52,2,2252,191,45
湖北,2020-02-10,80,90,7,2332,281,52
湖北,2020-02-11,66,59,2,2398,340,54
湖北,2020-02-12,230,89,4,2628,429,58
湖北,2020-02-13,163,77,1,2791,506,59
湖北,2020-02-14,26,107,9,2817,613,68
湖北,2020-02-15,6,105,7,2823,718,75
湖北,2020-02-16,5,122,3,2828,840,78
湖北,2020-02-17,0,103,6,2828,943,84
湖北,2020-02-18,16,116,1,2844,1059,85
湖北,2020-02-19,22,90,2,2866,1149,87
湖北,2020-02-20,17,125,3,2883,1274,90
湖北,2020-02-21,16,134,5,2899,1408,95
湖北,2020-02-22,5,132,3,2904,1540,98
湖北,2020-02-23,0,119,5,2904,1659,103
湖北,2020-02-24,0,101,3,2904,1760,106
湖北,2020-02-25,0,92,1,2904,1852,107
湖北,2020-02-26,0,96,3,2904,1948,110
湖北,2020-02-27,0,93,4,2904,2041,114
湖北,2020-02-28,0,78,1,2904,2119,115
湖北,2020-02-29,1,52,0,2905,2171,115
湖北,2020-03-01,0,89,1,2905,2260,116
湖北,2020-03-02,2,83,3,2907,2343,119
湖北,2020-03-03,0,63,2,2907,2406,121
湖北,2020-03-04,0,66,0,2907,2472,121
湖北,2020-03-05,0,54,1,2907,2526,122
湖北,2020-03-06,0,56,3,2907,2582,125
湖北,2020-03-07,0,45,0,2907,2627,125
湖北,2020-03-08,0,14,0,2907,2641,125
湖北,2020-03-09,0,16,0,2907,2657,125
湖北,2020-03-10,0,27,0,2907,2684,125
湖北,2020-03-11,0,21,0,2907,2705,125
湖北,2020-03-12,0,15,0,2907,2720,125
湖北,2020-03-13,0,10,0,2907,2730,125
湖北,2020-03-14,0,8,0,2907,2738,125
湖北,2020-03-15,0,12,0,2907,2750,125
湖北,2020-03-16,0,6,0,2907,2756,125
湖北,2020-03-17,0,23,0,2907,2779,125
湖北,2020-03-18,0,3,0,2907,2782,125
广东,2020-01-20,1,0,0,1,0,0
广东,2020-01-23,4,0,0,5,0,0
广东,2020-01-24,2,0,0,7,0,0
广东,2020-01-25,1,0,0,8,0,0
广东,2020-01-27,3,0,0,11,0,0
广东,2020-01-28,1,1,0,12,1,0
广东,2020-01-29,5,0,0,17,1,0
广东,2020-01-31,3,0,0,20,1,0
广东,2020-02-01,3,0,0,23,1,0
广东,2020-02-02,5,0,0,28,1,0
广东,2020-02-03,1,0,0,29,1,0
广东,2020-02-04,2,0,0,31,1,0
广东,2020-02-05,4,0,0,35,1,0
广东,2020-02-06,4,0,0,39,1,0
广东,2020-02-07,2,0,0,41,1,0
广东,2020-02-08,6,0,0,47,1,0
广东,2020-02-09,3,0,0,50,1,0
广东,2020-02-10,3,3,0,53,4,0
广东,2020-02-11,1,0,0,54,4,0
广东,2020-02-12,1,3,0,55,7,0
广东,2020-02-13,1,7,0,56,14,0
广东,2020-02-14,2,4,0,58,18,0
广东,2020-02-15,0,8,0,58,26,0
广东,2020-02-17,1,8,0,59,34,0
广东,2020-02-18,3,2,0,62,36,0
广东,2020-02-19,0,2,0,62,38,0
广东,2020-02-20,0,3,0,62,41,0
广东,2020-02-21,0,2,0,62,43,0
广东,2020-02-22,0,3,0,62,46,0
广东,2020-02-25,0,3,0,62,49,0
广东,2020-02-26,0,3,0,62,52,0
广东,2020-02-27,0,2,0,62,54,0
广东,2020-02-28,0,1,0,62,55,0
广东,2020-02-29,0,3,0,62,58,0
广东,2020-03-01,0,2,0,62,60,0
广东,2020-03-03,0,2,0,62,62,0
浙江,2020-01-20,1,0,0,1,0,0
浙江,2020-01-22,5,0,0,6,0,0
浙江,2020-01-23,12,0,0,18,0,0
浙江,2020-01-24,2,0,0,20,0,0
浙江,2020-01-25,1,0,0,21,0,0
浙江,2020-01-26,1,0,0,22,0,0
浙江,2020-01-28,18,0,0,40,0,0
浙江,2020-01-29,24,0,0,64,0,0
浙江,2020-01-30,17,0,0,81,0,0
浙江,2020-01-31,14,1,0,95,1,0
浙江,2020-02-01,5,3,0,100,4,0
浙江,2020-02-02,9,3,0,109,7,0
浙江,2020-02-03,6,4,0,115,11,0
浙江,2020-02-04,7,0,0,122,11,0
浙江,2020-02-05,2,3,0,124,14,0
浙江,2020-02-06,5,0,0,129,14,0
浙江,2020-02-07,4,3,0,133,17,0
浙江,2020-02-08,5,8,0,138,25,0
浙江,2020-02-09,3,2,0,141,27,0
浙江,2020-02-10,2,8,0,143,35,0
浙江,2020-02-11,0,3,0,143,38,0
浙江,2020-02-12,1,8,0,144,46,0
浙江,2020-02-13,0,3,0,144,49,0
浙江,2020-02-14,1,4,0,145,53,0
浙江,2020-02-15,1,7,0,146,60,0
浙江,2020-02-16,0,3,0,146,63,0
浙江,2020-02-17,0,1,0,146,64,0
浙江,2020-02-18,0,5,0,146,69,0
浙江,2020-02-19,0,5,0,146,74,0
浙江,2020-02-20,0,3,0,146,77,0
浙江,2020-02-21,0,7,0,146,84,0
浙江,2020-02-22,0,8,0,146,92,0
浙江,2020-02-23,0,6,0,146,98,0
浙江,2020-02-26,0,3,0,146,101,0
浙江,2020-02-27,0,2,0,146,103,0
浙江,2020-02-28,0,3,0,146,106,0
浙江,2020-02-29,0,1,0,146,107,0
浙江,2020-03-01,0,1,0,146,108,0
浙江,2020-03-02,0,4,0,146,112,0
浙江,2020-03-03,0,8,0,146,120,0
浙江,2020-03-04,0,7,0,146,127,0
浙江,2020-03-05,0,2,0,146,129,0
浙江,2020-03-06,0,1,0,146,130,0
浙江,2020-03-07,0,4,0,146,134,0
浙江,2020-03-08,0,3,0,146,137,0
浙江,2020-03-09,0,2,0,146,139,0
浙江,2020-03-10,0,5,0,146,144,0
浙江,2020-03-11,0,2,0,146,146,0
浙江,2020-06-16,1,0,0,147,146,0
上海,2020-01-20,1,0,0,1,0,0
上海,2020-01-24,0,1,0,1,1,0
上海,2020-01-25,1,0,0,2,1,0
上海,2020-01-26,0,0,1,2,1,1
上海,2020-01-27,32,2,0,34,3,1
上海,2020-01-28,7,1,0,41,4,1
上海,2020-01-29,8,1,0,49,5,1
上海,2020-01-30,10,0,0,59,5,1
上海,2020-01-31,10,0,0,69,5,1
上海,2020-02-01,6,0,0,75,5,1
上海,2020-02-02,2,0,0,77,5,1
上海,2020-02-03,3,0,0,80,5,1
上海,2020-02-04,5,0,0,85,5,1
上海,2020-02-05,4,3,0,89,8,1
上海,2020-02-06,4,6,0,93,14,1
上海,2020-02-07,2,2,0,95,16,1
上海,2020-02-08,3,4,0,98,20,1
上海,2020-02-09,0,1,0,98,21,1
上海,2020-02-10,0,2,0,98,23,1
上海,2020-02-11,2,3,0,100,26,1
上海,2020-02-13,3,1,0,103,27,1
上海,2020-02-14,7,8,0,110,35,1
上海,2020-02-15,0,13,0,110,48,1
上海,2020-02-16,0,5,0,110,53,1
上海,2020-02-17,1,6,0,111,59,1
上海,2020-02-18,0,5,0,111,64,1
上海,2020-02-19,0,2,0,111,66,1
上海,2020-02-20,0,3,0,111,69,1
上海,2020-02-21,0,4,0,111,73,1
上海,2020-02-22,1,4,0,112,77,1
上海,2020-02-23,0,4,0,112,81,1
上海,2020-02-24,0,5,0,112,86,1
上海,2020-02-25,0,3,0,112,89,1
上海,2020-02-27,0,2,0,112,91,1
上海,2020-02-29,0,3,0,112,94,1
上海,2020-03-01,0,1,0,112,95,1
上海,2020-03-02,0,1,0,112,96,1
上海,2020-03-03,0,1,0,112,97,1
上海,2020-03-04,0,1,0,112,98,1
上海,2020-03-06,0,1,0,112,99,1
上海,2020-03-07,0,1,0,112,100,1
上海,2020-03-10,0,3,0,112,103,1
上海,2020-03-11,0,1,0,112,104,1
上海,2020-03-13,0,2,0,112,106,1
上海,2020-05-17,1,0,0,113,106,1
上海,2020-05-20,1,0,0,114,106,1
上海,2020-05-27,0,1,0,114,107,1
上海,2020-06-01,0,1,0,114,108,1
北京,2020-01-20,1,0,0,1,0,0
北京,2020-01-22,1,0,0,2,0,0
北京,2020-01-23,5,0,0,7,0,0
北京,2020-01-24,4,0,0,11,0,0
北京,2020-02-02,8,0,0,19,0,0
北京,2020-02-03,1,0,0,20,0,0
北京,2020-02-04,1,0,0,21,0,0
北京,2020-02-06,3,0,0,24,0,0
北京,2020-02-09,1,0,0,25,0,0
浙江,2020-01-20,2,0,0,2,0,0
浙江,2020-01-21,2,0,0,4,0,0
浙江,2020-01-22,2,1,0,6,1,0
浙江,2020-01-24,4,0,0,10,1,0
浙江,2020-01-25,8,0,0,18,1,0
浙江,2020-01-26,14,0,0,32,1,0
浙江,2020-01-27,28,0,0,60,1,0
浙江,2020-01-28,54,2,0,114,3,0
浙江,2020-01-29,58,0,0,172,3,0
浙江,2020-01-30,55,4,0,227,7,0
浙江,2020-01-31,14,1,0,241,8,0
浙江,2020-02-01,24,2,0,265,10,0
浙江,2020-02-02,26,5,0,291,15,0
浙江,2020-02-03,49,2,0,340,17,0
浙江,2020-02-04,24,11,0,364,28,0
浙江,2020-02-05,32,0,0,396,28,0
浙江,2020-02-06,25,8,0,421,36,0
浙江,2020-02-07,17,13,0,438,49,0
浙江,2020-02-08,10,21,0,448,70,0
浙江,2020-02-09,16,8,0,464,78,0
浙江,2020-02-10,10,21,0,474,99,0
浙江,2020-02-11,7,8,0,481,107,0
浙江,2020-02-12,9,13,0,490,120,0
浙江,2020-02-13,6,20,0,496,140,0
浙江,2020-02-14,3,19,0,499,159,0
浙江,2020-02-15,3,10,0,502,169,0
浙江,2020-02-16,1,13,0,503,182,0
浙江,2020-02-17,1,12,0,504,194,0
浙江,2020-02-18,0,14,0,504,208,0
浙江,2020-02-19,0,20,0,504,228,0
浙江,2020-02-20,0,17,1,504,245,1
浙江,2020-02-21,0,23,0,504,268,1
浙江,2020-02-22,0,12,0,504,280,1
浙江,2020-02-23,0,12,0,504,292,1
浙江,2020-02-24,0,14,0,504,306,1
浙江,2020-02-25,0,11,0,504,317,1
浙江,2020-02-26,0,37,0,504,354,1
浙江,2020-02-27,0,30,0,504,384,1
浙江,2020-02-28,0,21,0,504,405,1
浙江,2020-02-29,0,27,0,504,432,1
浙江,2020-03-01,0,15,0,504,447,1
浙江,2020-03-02,0,9,0,504,456,1
浙江,2020-03-03,0,10,0,504,466,1
浙江,2020-03-04,0,12,0,504,478,1
浙江,2020-03-05,0,4,0,504,482,1
浙江,2020-03-06,0,5,0,504,487,1
浙江,2020-03-07,0,1,0,504,488,1
浙江,2020-03-08,0,4,0,504,492,1
浙江,2020-03-09,0,1,0,504,493,1
浙江,2020-03-10,0,6,0,504,499,1
浙江,2020-03-11,0,2,0,504,501,1
浙江,2020-03-16,0,2,0,504,503,1
广东,2020-01-20,1,0,0,1,0,0
广东,2020-01-21,1,0,0,2,0,0
广东,2020-01-25,2,0,0,4,0,0
广东,2020-01-26,1,0,0,5,0,0
广东,2020-01-28,2,0,0,7,0,0
广东,2020-01-29,2,1,0,9,1,0
广东,2020-01-30,2,0,0,11,1,0
广东,2020-01-31,2,0,0,13,1,0
广东,2020-02-01,1,0,0,14,1,0
广东,2020-02-03,1,0,0,15,1,0
广东,2020-02-04,3,0,0,18,1,0
广东,2020-02-05,1,3,0,19,4,0
广东,2020-02-07,1,0,0,20,4,0
广东,2020-02-08,1,2,0,21,6,0
广东,2020-02-10,0,1,0,21,7,0
广东,2020-02-11,0,2,0,21,9,0
广东,2020-02-13,1,2,0,22,11,0
广东,2020-02-20,0,1,0,22,12,0
广东,2020-02-23,0,2,0,22,14,0
广东,2020-02-27,0,3,0,22,17,0
广东,2020-03-02,0,2,0,22,19,0
广东,2020-03-04,0,1,0,22,20,0
浙江,2020-01-20,1,0,0,1,0,0
浙江,2020-01-24,1,0,0,2,0,0
浙江,2020-01-26,2,0,0,4,0,0
浙江,2020-01-28,2,0,0,6,0,0
浙江,2020-01-30,1,1,0,7,1,0
浙江,2020-02-02,0,1,0,7,2,0
浙江,2020-02-05,0,1,0,7,3,0
浙江,2020-02-06,0,1,0,7,4,0
浙江,2020-02-07,0,1,0,7,5,0
浙江,2020-02-10,3,0,0,10,5,0
浙江,2020-02-25,0,1,0,10,6,0
浙江,2020-02-27,0,1,0,10,7,0
浙江,2020-02-29,0,1,0,10,8,0
浙江,2020-03-02,0,2,0,10,10,0
广东,2020-01-20,3,0,0,3,0,0
广东,2020-01-21,1,0,0,4,0,0
广东,2020-01-23,4,0,0,8,0,0
广东,2020-01-24,2,0,0,10,0,0
广东,2020-01-26,2,0,0,12,0,0
广东,2020-01-28,2,0,0,14,0,0
广东,2020-01-29,4,0,0,18,0,0
广东,2020-01-30,8,1,0,26,1,0
广东,2020-01-31,12,0,0,38,1,0
广东,2020-02-01,3,0,0,41,1,0
广东,2020-02-02,10,0,0,51,1,0
广东,2020-02-03,13,0,0,64,1,0
广东,2020-02-04,5,0,0,69,1,0
广东,2020-02-05,4,3,0,73,4,0
广东,2020-02-07,9,0,0,82,4,0
广东,2020-02-08,1,0,0,83,4,0
广东,2020-02-09,2,5,0,85,9,0
广东,2020-02-10,1,5,0,86,14,0
广东,2020-02-11,1,3,0,87,17,0
广东,2020-02-12,2,4,0,89,21,0
广东,2020-02-13,2,6,0,91,27,0
广东,2020-02-14,4,7,0,95,34,0
广东,2020-02-15,1,3,0,96,37,0
广东,2020-02-16,1,4,0,97,41,0
广东,2020-02-17,1,2,0,98,43,0
广东,2020-02-18,0,2,1,98,45,1
广东,2020-02-20,0,4,0,98,49,1
广东,2020-02-21,0,3,0,98,52,1
广东,2020-02-23,0,2,0,98,54,1
广东,2020-02-24,0,2,0,98,56,1
广东,2020-02-25,0,3,0,98,59,1
广东,2020-02-26,0,2,0,98,61,1
广东,2020-02-27,0,2,0,98,63,1
广东,2020-02-28,0,8,0,98,71,1
广东,2020-02-29,0,4,0,98,75,1
广东,2020-03-01,0,5,0,98,80,1
广东,2020-03-02,0,1,0,98,81,1
广东,2020-03-03,0,1,0,98,82,1
广东,2020-03-04,0,1,0,98,83,1
广东,2020-03-05,0,7,0,98,90,1
广东,2020-03-06,0,5,0,98,95,1
广东,2020-03-11,0,2,0,98,97,1
四川,2020-01-21,1,0,0,1,0,0
四川,2020-01-22,3,0,0,4,0,0
四川,2020-01-23,3,0,0,7,0,0
四川,2020-01-24,9,0,0,16,0,0
四川,2020-01-25,6,0,0,22,0,0
四川,2020-01-26,11,0,0,33,0,0
四川,2020-01-27,4,0,0,37,0,0
四川,2020-01-28,9,0,0,46,0,0
四川,2020-01-29,13,1,1,59,1,1
四川,2020-01-30,10,0,0,69,1,1
四川,2020-01-31,3,2,0,72,3,1
四川,2020-02-01,1,0,0,73,3,1
四川,2020-02-02,4,7,0,77,10,1
四川,2020-02-03,10,0,0,87,10,1
四川,2020-02-04,5,7,0,92,17,1
四川,2020-02-05,5,2,0,97,19,1
四川,2020-02-06,5,6,0,102,25,1
四川,2020-02-07,7,5,0,109,30,1
四川,2020-02-08,11,5,0,120,35,1
四川,2020-02-09,3,3,0,123,38,1
四川,2020-02-10,1,3,0,124,41,1
四川,2020-02-11,1,0,0,125,41,1
四川,2020-02-12,6,1,0,131,42,1
四川,2020-02-13,4,1,0,135,43,1
四川,2020-02-14,4,1,0,139,44,1
四川,2020-02-15,1,5,2,140,49,3
四川,2020-02-16,0,4,0,140,53,3
四川,2020-02-17,0,3,0,140,56,3
四川,2020-02-18,1,5,0,141,61,3
四川,2020-02-19,0,8,0,141,69,3
四川,2020-02-20,2,2,0,143,71,3
四川,2020-02-21,0,4,0,143,75,3
四川,2020-02-22,0,3,0,143,78,3
四川,2020-02-24,0,1,0,143,79,3
四川,2020-02-25,0,2,0,143,81,3
四川,2020-02-26,0,2,0,143,83,3
四川,2020-02-27,0,2,0,143,85,3
四川,2020-02-28,0,3,0,143,88,3
四川,2020-03-01,0,2,0,143,90,3
四川,2020-03-02,0,2,0,143,92,3
四川,2020-03-03,0,1,0,143,93,3
四川,2020-03-04,1,4,0,144,97,3
四川,2020-03-05,0,1,0,144,98,3
四川,2020-03-06,0,2,0,144,100,3
四川,2020-03-07,0,1,0,144,101,3
四川,2020-03-08,0,1,0,144,102,3
四川,2020-03-09,0,1,0,144,103,3
四川,2020-03-10,0,5,0,144,108,3
四川,2020-03-11,0,5,0,144,113,3
四川,2020-03-12,0,2,0,144,115,3
四川,2020-03-13,0,6,0,144,121,3
四川,2020-03-14,0,1,0,144,122,3
四川,2020-03-16,0,4,0,144,126,3
四川,2020-03-17,0,5,0,144,131,3
四川,2020-03-18,0,6,0,144,137,3
四川,2020-03-19,0,4,0,144,141,3
四川,2020-04-17,1,0,0,145,141,3
四川,2020-06-10,0,1,0,145,142,3
重庆,2020-01-21,1,0,0,1,0,0
重庆,2020-01-23,1,0,0,2,0,0
重庆,2020-01-26,2,0,0,4,0,0
重庆,2020-01-27,1,0,0,5,0,0
重庆,2020-01-30,3,0,0,8,0,0
重庆,2020-01-31,2,0,0,10,0,0
重庆,2020-02-01,1,0,0,11,0,0
重庆,2020-02-02,1,0,0,12,0,0
重庆,2020-02-03,1,1,0,13,1,0
重庆,2020-02-04,2,0,0,15,1,0
重庆,2020-02-05,1,0,0,16,1,0
重庆,2020-02-06,1,0,0,17,1,0
重庆,2020-02-07,1,0,0,18,1,0
重庆,2020-02-08,1,0,0,19,1,0
重庆,2020-02-09,1,0,0,20,1,0
重庆,2020-02-13,0,2,0,20,3,0
重庆,2020-02-14,0,1,0,20,4,0
重庆,2020-02-15,0,1,0,20,5,0
重庆,2020-02-16,0,1,0,20,6,0
重庆,2020-02-18,0,1,0,20,7,0
重庆,2020-02-19,0,2,0,20,9,0
重庆,2020-02-22,0,1,0,20,10,0
重庆,2020-02-27,0,2,0,20,12,0
重庆,2020-02-29,0,2,0,20,14,0
重庆,2020-03-01,0,1,0,20,15,0
重庆,2020-03-03,0,2,0,20,17,0
重庆,2020-03-05,0,2,0,20,19,0
重庆,2020-03-09,0,1,0,20,20,0
北京,2020-01-21,1,0,0,1,0,0
北京,2020-01-23,1,0,0,2,0,0
北京,2020-01-25,1,0,0,3,0,0
北京,2020-01-26,1,0,0,4,0,0
北京,2020-01-27,3,0,0,7,0,0
北京,2020-01-28,1,0,0,8,0,0
北京,2020-01-29,3,0,0,11,0,0
北京,2020-01-31,1,0,0,12,0,0
北京,2020-02-01,4,0,0,16,0,0
北京,2020-02-02,1,0,0,17,0,0
北京,2020-02-03,1,0,0,18,0,0
北京,2020-02-04,2,0,0,20,0,0
北京,2020-02-06,2,0,0,22,0,0
北京,2020-02-07,4,0,0,26,0,0
北京,2020-02-08,1,0,0,27,0,0
北京,2020-02-09,3,0,0,30,0,0
北京,2020-02-11,2,0,0,32,0,0
北京,2020-02-12,4,0,0,36,0,0
北京,2020-02-14,2,0,0,38,0,0
北京,2020-02-15,1,0,0,39,0,0
北京,2020-02-17,1,0,0,40,0,0
北京,2020-02-20,1,0,0,41,0,0
北京,2020-02-26,1,0,0,42,0,0
北京,2020-03-03,1,0,0,43,0,0
北京,2020-06-12,5,0,0,48,0,0
北京,2020-06-13,30,0,0,78,0,0
北京,2020-06-14,23,0,0,101,0,0
北京,2020-06-15,22,0,0,123,0,0
北京,2020-06-16,19,0,0,142,0,0
北京,2020-06-17,14,0,0,156,0,0
北京,2020-06-18,18,0,0,174,0,0
北京,2020-06-19,13,0,0,187,0,0
北京,2020-06-20,10,0,0,197,0,0
北京,2020-06-21,5,0,0,202,0,0
北京,2020-06-22,6,0,0,208,0,0
北京,2020-06-23,6,0,0,214,0,0
北京,2020-06-24,9,0,0,223,0,0
北京,2020-06-25,7,0,0,230,0,0
北京,2020-06-26,15,0,0,245,0,0
北京,2020-06-27,10,0,0,255,0,0
北京,2020-06-28,5,0,0,260,0,0
北京,2020-06-29,6,0,0,266,0,0
广东,2020-01-21,1,0,0,1,0,0
广东,2020-01-23,5,0,0,6,0,0
广东,2020-01-24,3,0,0,9,0,0
广东,2020-01-25,1,0,0,10,0,0
广东,2020-01-26,4,0,0,14,0,0
广东,2020-01-27,4,0,0,18,0,0
广东,2020-01-29,7,0,0,25,0,0
广东,2020-01-30,7,0,0,32,0,0
广东,2020-01-31,6,1,0,38,1,0
广东,2020-02-01,1,0,0,39,1,0
广东,2020-02-02,4,0,0,43,1,0
广东,2020-02-03,3,0,0,46,1,0
广东,2020-02-04,3,0,0,49,1,0
广东,2020-02-05,1,0,0,50,1,0
广东,2020-02-06,7,3,0,57,4,0
广东,2020-02-07,3,0,0,60,4,0
广东,2020-02-08,5,0,0,65,4,0
广东,2020-02-09,3,0,0,68,4,0
广东,2020-02-10,2,0,0,70,4,0
广东,2020-02-11,8,11,0,78,15,0
广东,2020-02-12,3,2,0,81,17,0
广东,2020-02-13,1,1,0,82,18,0
广东,2020-02-14,2,4,0,84,22,0
广东,2020-02-15,0,1,0,84,23,0
广东,2020-02-18,0,4,0,84,27,0
广东,2020-02-19,0,6,0,84,33,0
广东,2020-02-22,0,1,0,84,34,0
广东,2020-02-23,0,2,0,84,36,0
广东,2020-03-03,0,30,0,84,66,0
广东,2020-03-04,0,3,0,84,69,0
广东,2020-03-05,0,1,0,84,70,0
广东,2020-03-06,0,2,0,84,72,0
广东,2020-03-07,0,3,0,84,75,0
广东,2020-03-08,0,2,0,84,77,0
广东,2020-03-12,0,1,0,84,78,0
广东,2020-03-13,0,1,0,84,79,0
广东,2020-03-14,0,1,0,84,80,0
广东,2020-03-23,1,0,0,85,80,0
广东,2020-04-13,1,0,0,86,80,0
广东,2020-04-15,1,0,0,87,80,0
广东,2020-04-20,1,0,0,88,80,0
广东,2020-04-22,1,0,0,89,80,0
江西,2020-01-21,1,0,0,1,0,0
江西,2020-01-24,3,0,0,4,0,0
江西,2020-01-25,2,0,0,6,0,0
江西,2020-01-26,1,0,0,7,0,0
江西,2020-01-27,1,0,0,8,0,0
江西,2020-01-28,1,0,0,9,0,0
江西,2020-01-29,4,0,0,13,0,0
江西,2020-01-30,2,0,0,15,0,0
江西,2020-01-31,3,0,0,18,0,0
江西,2020-02-01,6,0,0,24,0,0
江西,2020-02-02,5,0,0,29,0,0
江西,2020-02-03,5,0,0,34,0,0
江西,2020-02-04,10,1,0,44,1,0
江西,2020-02-05,2,4,0,46,5,0
江西,2020-02-06,10,2,0,56,7,0
江西,2020-02-07,3,0,0,59,7,0
江西,2020-02-08,4,0,0,63,7,0
江西,2020-02-09,1,2,0,64,9,0
江西,2020-02-10,3,0,0,67,9,0
江西,2020-02-11,1,2,0,68,11,0
江西,2020-02-12,1,3,0,69,14,0
江西,2020-02-13,2,0,0,71,14,0
江西,2020-02-14,1,3,0,72,17,0
江西,2020-02-15,0,3,0,72,20,0
江西,2020-02-16,0,2,0,72,22,0
江西,2020-02-17,0,6,0,72,28,0
江西,2020-02-18,0,1,0,72,29,0
江西,2020-02-19,0,6,0,72,35,0
江西,2020-02-20,0,2,0,72,37,0
江西,2020-02-21,0,9,0,72,46,0
江西,2020-02-22,0,1,0,72,47,0
江西,2020-02-23,0,4,0,72,51,0
江西,2020-02-24,0,1,0,72,52,0
江西,2020-02-25,0,6,0,72,58,0
江西,2020-02-26,0,3,0,72,61,0
江西,2020-02-28,0,2,0,72,63,0
江西,2020-02-29,0,2,0,72,65,0
江西,2020-03-02,0,5,0,72,70,0
江西,2020-03-04,0,1,0,72,71,0
江西,2020-03-06,0,1,0,72,72,0
四川,2020-01-21,1,0,0,1,0,0
四川,2020-01-23,1,0,0,2,0,0
四川,2020-01-26,4,0,0,6,0,0
四川,2020-01-27,1,0,0,7,0,0
四川,2020-01-29,2,0,0,9,0,0
四川,2020-01-30,4,0,0,13,0,0
四川,2020-01-31,3,0,0,16,0,0
四川,2020-02-01,4,0,0,20,0,0
四川,2020-02-02,1,1,0,21,1,0
四川,2020-02-03,3,0,0,24,1,0
四川,2020-02-06,3,0,0,27,1,0
四川,2020-02-07,1,2,0,28,3,0
四川,2020-02-10,2,0,0,30,3,0
四川,2020-02-12,0,2,0,30,5,0
四川,2020-02-13,0,2,0,30,7,0
四川,2020-02-14,0,1,0,30,8,0
四川,2020-02-15,0,2,0,30,10,0
四川,2020-02-17,0,4,0,30,14,0
四川,2020-02-18,0,2,0,30,16,0
四川,2020-02-19,0,3,0,30,19,0
四川,2020-02-20,0,1,0,30,20,0
四川,2020-02-27,0,1,0,30,21,0
四川,2020-02-28,0,2,0,30,23,0
四川,2020-02-29,0,1,0,30,24,0
四川,2020-03-01,0,1,0,30,25,0
四川,2020-03-04,0,1,0,30,26,0
四川,2020-03-06,0,1,0,30,27,0
四川,2020-03-09,0,1,0,30,28,0
四川,2020-03-12,0,1,0,30,29,0
四川,2020-03-13,0,1,0,30,30,0
广东,2020-01-21,2,0,0,2,0,0
广东,2020-01-22,3,0,0,5,0,0
广东,2020-01-23,2,0,0,7,0,0
广东,2020-01-24,7,0,0,14,0,0
广东,2020-01-26,25,0,0,39,0,0
广东,2020-01-27,12,0,0,51,0,0
广东,2020-01-28,12,0,0,63,0,0
广东,2020-01-29,16,0,0,79,0,0
广东,2020-01-30,27,1,0,106,1,0
广东,2020-01-31,31,2,0,137,3,0
广东,2020-02-01,38,0,0,175,3,0
广东,2020-02-02,14,0,0,189,3,0
广东,2020-02-03,27,0,0,216,3,0
广东,2020-02-04,21,4,0,237,7,0
广东,2020-02-05,18,6,0,255,13,0
广东,2020-02-06,29,7,0,284,20,0
广东,2020-02-07,14,7,0,298,27,0
广东,2020-02-08,6,9,0,304,36,0
广东,2020-02-09,9,6,0,313,42,0
广东,2020-02-10,4,7,0,317,49,0
广东,2020-02-11,6,21,0,323,70,0
广东,2020-02-12,4,8,0,327,78,0
广东,2020-02-13,1,15,0,328,93,0
广东,2020-02-14,7,13,0,335,106,0
广东,2020-02-15,3,15,0,338,121,0
广东,2020-02-16,1,10,0,339,131,0
广东,2020-02-17,0,11,0,339,142,0
广东,2020-02-18,0,6,0,339,148,0
广东,2020-02-19,0,9,0,339,157,0
广东,2020-02-20,0,15,0,339,172,0
广东,2020-02-21,4,18,0,343,190,0
广东,2020-02-22,2,6,0,345,196,0
广东,2020-02-23,0,8,0,345,204,0
广东,2020-02-24,1,6,1,346,210,1
广东,2020-02-25,0,12,0,346,222,1
广东,2020-02-26,0,8,0,346,230,1
广东,2020-02-27,0,10,0,346,240,1
广东,2020-02-28,0,8,0,346,248,1
广东,2020-02-29,0,12,0,346,260,1
广东,2020-03-01,0,4,0,346,264,1
广东,2020-03-02,0,7,0,346,271,1
广东,2020-03-03,0,12,0,346,283,1
广东,2020-03-04,0,9,0,346,292,1
广东,2020-03-05,1,17,0,347,309,1
广东,2020-03-06,0,9,0,347,318,1
广东,2020-03-07,0,3,0,347,321,1
广东,2020-03-08,0,1,0,347,322,1
广东,2020-03-09,0,2,0,347,324,1
广东,2020-03-10,0,2,0,347,326,1
广东,2020-03-12,0,4,0,347,330,1
广东,2020-03-21,1,0,0,348,330,1
广东,2020-04-02,1,0,0,349,330,1
广东,2020-04-04,3,0,0,352,330,1
广东,2020-04-07,1,0,0,353,330,1
广东,2020-04-08,2,0,0,355,330,1
广东,2020-04-09,2,0,0,357,330,1
广东,2020-04-10,3,0,0,360,330,1
广东,2020-04-12,3,0,0,363,330,1
广东,2020-04-13,2,0,0,365,330,1
广东,2020-04-14,2,0,0,367,330,1
广东,2020-04-15,4,0,0,371,330,1
广东,2020-04-16,4,0,0,375,330,1
广东,2020-04-23,1,0,0,376,330,1
广东,2020-04-25,1,0,0,377,330,1
北京,2020-01-21,2,0,0,2,0,0
北京,2020-01-23,1,0,0,3,0,0
北京,2020-01-24,5,0,0,8,0,0
北京,2020-01-25,5,0,0,13,0,0
北京,2020-01-26,4,0,0,17,0,0
北京,2020-01-27,4,0,0,21,0,0
北京,2020-01-28,2,0,0,23,0,0
北京,2020-01-29,1,0,0,24,0,0
北京,2020-01-30,2,0,0,26,0,0
北京,2020-01-31,9,0,0,35,0,0
北京,2020-02-01,6,0,0,41,0,0
北京,2020-02-02,1,0,0,42,0,0
北京,2020-02-03,3,0,0,45,0,0
北京,2020-02-05,2,0,0,47,0,0
北京,2020-02-07,2,0,0,49,0,0
北京,2020-02-08,3,0,0,52,0,0
北京,2020-02-09,2,0,0,54,0,0
北京,2020-02-10,2,0,0,56,0,0
北京,2020-02-13,2,0,0,58,0,0
北京,2020-02-14,1,0,0,59,0,0
北京,2020-02-15,1,0,0,60,0,0
北京,2020-02-18,1,0,0,61,0,0
北京,2020-02-21,1,0,0,62,0,0
北京,2020-03-01,1,0,0,63,0,0
北京,2020-03-23,1,0,0,64,0,0
北京,2020-06-14,2,0,0,66,0,0
北京,2020-06-16,3,0,0,69,0,0
北京,2020-06-17,1,0,0,70,0,0
北京,2020-06-18,1,0,0,71,0,0
北京,2020-06-19,1,0,0,72,0,0
北京,2020-06-20,3,0,0,75,0,0
北京,2020-06-21,2,0,0,77,0,0
北京,2020-06-22,3,0,0,80,0,0
北京,2020-06-25,2,0,0,82,0,0
安徽,2020-01-21,1,0,0,1,0,0
安徽,2020-01-22,4,0,0,5,0,0
安徽,2020-01-23,1,0,0,6,0,0
安徽,2020-01-24,4,0,0,10,0,0
安徽,2020-01-25,3,0,0,13,0,0
安徽,2020-01-27,3,0,0,16,0,0
安徽,2020-01-28,13,0,0,29,0,0
安徽,2020-01-29,10,1,0,39,1,0
安徽,2020-01-30,11,0,0,50,1,0
安徽,2020-01-31,9,0,0,59,1,0
安徽,2020-02-01,0,1,0,59,2,0
安徽,2020-02-02,16,0,0,75,2,0
安徽,2020-02-03,6,3,0,81,5,0
安徽,2020-02-04,12,0,0,93,5,0
安徽,2020-02-05,11,0,0,104,5,0
安徽,2020-02-06,11,2,0,115,7,0
安徽,2020-02-07,13,2,0,128,9,0
安徽,2020-02-08,8,2,0,136,11,0
安徽,2020-02-09,11,0,0,147,11,0
安徽,2020-02-10,3,4,1,150,15,1
安徽,2020-02-11,7,7,0,157,22,1
安徽,2020-02-12,4,6,0,161,28,1
安徽,2020-02-13,5,7,0,166,35,1
安徽,2020-02-14,2,3,0,168,38,1
安徽,2020-02-15,1,5,0,169,43,1
安徽,2020-02-16,2,6,0,171,49,1
安徽,2020-02-17,2,1,0,173,50,1
安徽,2020-02-18,0,21,0,173,71,1
安徽,2020-02-19,0,4,0,173,75,1
安徽,2020-02-20,1,11,0,174,86,1
安徽,2020-02-21,0,11,0,174,97,1
安徽,2020-02-22,0,4,0,174,101,1
安徽,2020-02-23,0,2,0,174,103,1
安徽,2020-02-24,0,16,0,174,119,1
安徽,2020-02-25,0,8,0,174,127,1
安徽,2020-02-26,0,8,0,174,135,1
安徽,2020-02-27,0,3,0,174,138,1
安徽,2020-02-28,0,2,0,174,140,1
安徽,2020-02-29,0,3,0,174,143,1
安徽,2020-03-01,0,4,0,174,147,1
安徽,2020-03-02,0,6,0,174,153,1
安徽,2020-03-03,0,4,0,174,157,1
安徽,2020-03-05,0,8,0,174,165,1
安徽,2020-03-06,0,4,0,174,169,1
安徽,2020-03-07,0,2,0,174,171,1
安徽,2020-03-08,0,2,0,174,173,1
天津,2020-01-21,1,0,0,1,0,0
天津,2020-01-24,1,0,0,2,0,0
天津,2020-01-27,3,0,0,5,0,0
天津,2020-02-01,1,0,0,6,0,0
天津,2020-02-02,3,0,0,9,0,0
天津,2020-02-04,1,1,0,10,1,0
天津,2020-02-10,1,1,1,11,2,1
天津,2020-02-11,2,0,0,13,2,1
天津,2020-02-13,1,2,0,14,4,1
天津,2020-02-14,0,1,0,14,5,1
天津,2020-02-15,0,2,0,14,7,1
天津,2020-02-16,1,0,0,15,7,1
天津,2020-02-20,0,1,0,15,8,1
天津,2020-02-23,0,2,0,15,10,1
天津,2020-02-24,0,1,0,15,11,1
天津,2020-03-01,0,2,0,15,13,1
天津,2020-03-03,0,1,0,15,14,1
云南,2020-01-21,1,0,0,1,0,0
云南,2020-01-23,1,0,0,2,0,0
云南,2020-01-24,1,0,0,3,0,0
云南,2020-01-25,1,0,0,4,0,0
云南,2020-01-26,3,0,0,7,0,0
云南,2020-01-27,5,0,0,12,0,0
云南,2020-01-28,3,0,0,15,0,0
云南,2020-01-29,6,0,0,21,0,0
云南,2020-01-30,3,0,0,24,0,0
云南,2020-01-31,6,0,0,30,0,0
云南,2020-02-01,1,0,0,31,0,0
云南,2020-02-02,1,0,0,32,0,0
云南,2020-02-03,2,0,0,34,0,0
云南,2020-02-05,3,0,0,37,0,0
云南,2020-02-06,3,0,0,40,0,0
云南,2020-02-07,1,2,0,41,2,0
云南,2020-02-08,0,4,0,41,6,0
云南,2020-02-09,1,0,0,42,6,0
云南,2020-02-10,3,0,0,45,6,0
云南,2020-02-11,1,0,0,46,6,0
云南,2020-02-12,1,1,0,47,7,0
云南,2020-02-13,1,1,0,48,8,0
云南,2020-02-15,1,0,0,49,8,0
云南,2020-02-16,2,0,0,51,8,0
云南,2020-02-17,1,3,0,52,11,0
云南,2020-02-18,0,2,0,52,13,0
云南,2020-02-19,0,2,0,52,15,0
云南,2020-02-20,1,9,0,53,24,0
云南,2020-02-21,0,8,0,53,32,0
云南,2020-02-24,0,4,0,53,36,0
云南,2020-02-26,0,12,0,53,48,0
云南,2020-03-02,0,4,0,53,52,0
云南,2020-03-06,0,1,0,53,53,0
浙江,2020-01-21,3,0,0,3,0,0
浙江,2020-01-22,2,0,0,5,0,0
浙江,2020-01-24,1,0,0,6,0,0
浙江,2020-01-25,7,0,0,13,0,0
浙江,2020-01-27,4,0,0,17,0,0
浙江,2020-01-28,3,0,0,20,0,0
浙江,2020-01-29,21,0,0,41,0,0
浙江,2020-01-30,5,0,0,46,0,0
浙江,2020-01-31,9,1,0,55,1,0
浙江,2020-02-01,11,0,0,66,1,0
浙江,2020-02-02,9,0,0,75,1,0
浙江,2020-02-03,27,0,0,102,1,0
浙江,2020-02-04,18,3,0,120,4,0
浙江,2020-02-05,6,2,0,126,6,0
浙江,2020-02-06,10,3,0,136,9,0
浙江,2020-02-07,5,3,0,141,12,0
浙江,2020-02-08,5,1,0,146,13,0
浙江,2020-02-09,3,2,0,149,15,0
浙江,2020-02-10,2,3,0,151,18,0
浙江,2020-02-11,2,6,0,153,24,0
浙江,2020-02-12,0,7,0,153,31,0
浙江,2020-02-13,0,4,0,153,35,0
浙江,2020-02-14,1,11,0,154,46,0
浙江,2020-02-15,1,7,0,155,53,0
浙江,2020-02-16,1,9,0,156,62,0
浙江,2020-02-17,0,6,0,156,68,0
浙江,2020-02-18,0,5,0,156,73,0
浙江,2020-02-19,0,18,0,156,91,0
浙江,2020-02-20,1,10,0,157,101,0
浙江,2020-02-21,0,5,0,157,106,0
浙江,2020-02-22,0,3,0,157,109,0
浙江,2020-02-23,0,5,0,157,114,0
浙江,2020-02-24,0,7,0,157,121,0
浙江,2020-02-25,0,1,0,157,122,0
浙江,2020-02-26,0,12,0,157,134,0
浙江,2020-02-27,0,4,0,157,138,0
浙江,2020-02-28,0,7,0,157,145,0
浙江,2020-02-29,0,3,0,157,148,0
浙江,2020-03-01,0,1,0,157,149,0
浙江,2020-03-02,0,2,0,157,151,0
浙江,2020-03-03,0,3,0,157,154,0
浙江,2020-03-05,0,1,0,157,155,0
浙江,2020-03-09,0,2,0,157,157,0
江西,2020-01-21,1,0,0,1,0,0
江西,2020-01-25,1,0,0,2,0,0
江西,2020-01-27,0,1,0,2,1,0
江西,2020-01-29,3,0,0,5,1,0
江西,2020-01-30,3,0,0,8,1,0
江西,2020-01-31,1,0,0,9,1,0
江西,2020-02-01,6,0,0,15,1,0
江西,2020-02-02,3,0,0,18,1,0
江西,2020-02-03,2,0,0,20,1,0
江西,2020-02-04,2,0,0,22,1,0
江西,2020-02-05,1,0,0,23,1,0
江西,2020-02-06,1,0,0,24,1,0
江西,2020-02-09,1,0,0,25,1,0
江西,2020-02-10,1,0,0,26,1,0
江西,2020-02-11,3,1,0,29,2,0
江西,2020-02-13,2,0,0,31,2,0
江西,2020-02-14,1,2,0,32,4,0
江西,2020-02-16,1,1,0,33,5,0
江西,2020-02-17,0,1,0,33,6,0
江西,2020-02-18,0,1,0,33,7,0
江西,2020-02-19,0,2,0,33,9,0
江西,2020-02-20,0,2,0,33,11,0
江西,2020-02-22,0,2,0,33,13,0
江西,2020-02-23,0,3,0,33,16,0
江西,2020-02-25,0,2,0,33,18,0
江西,2020-02-26,0,2,0,33,20,0
江西,2020-02-27,0,3,0,33,23,0
江西,2020-02-28,0,1,0,33,24,0
江西,2020-02-29,0,1,0,33,25,0
江西,2020-03-03,0,2,0,33,27,0
江西,2020-03-04,0,6,0,33,33,0
山东,2020-01-21,1,0,0,1,0,0
山东,2020-01-22,2,0,0,3,0,0
山东,2020-01-24,1,0,0,4,0,0
山东,2020-01-25,2,0,0,6,0,0
山东,2020-01-26,4,0,0,10,0,0
山东,2020-01-27,3,0,0,13,0,0
山东,2020-01-28,2,0,0,15,0,0
山东,2020-01-29,3,1,0,18,1,0
山东,2020-01-30,3,0,0,21,1,0
山东,2020-02-01,1,0,0,22,1,0
山东,2020-02-02,3,0,0,25,1,0
山东,2020-02-03,4,0,0,29,1,0
山东,2020-02-04,5,2,0,34,3,0
山东,2020-02-05,7,0,0,41,3,0
山东,2020-02-06,2,1,0,43,4,0
山东,2020-02-07,3,1,0,46,5,0
山东,2020-02-08,1,2,0,47,7,0
山东,2020-02-09,5,3,1,52,10,1
山东,2020-02-10,1,1,0,53,11,1
山东,2020-02-11,0,1,0,53,12,1
山东,2020-02-12,0,1,0,53,13,1
山东,2020-02-13,0,2,0,53,15,1
山东,2020-02-14,3,4,0,56,19,1
山东,2020-02-15,1,3,0,57,22,1
山东,2020-02-16,0,4,0,57,26,1
山东,2020-02-17,1,0,0,58,26,1
山东,2020-02-18,1,2,0,59,28,1
山东,2020-02-19,0,1,0,59,29,1
山东,2020-02-20,0,4,0,59,33,1
山东,2020-02-21,0,1,0,59,34,1
山东,2020-02-23,1,2,0,60,36,1
山东,2020-02-24,0,2,0,60,38,1
山东,2020-02-25,0,1,0,60,39,1
山东,2020-02-26,0,3,0,60,42,1
山东,2020-02-27,0,3,0,60,45,1
山东,2020-02-28,0,3,0,60,48,1
山东,2020-02-29,0,3,0,60,51,1
山东,2020-03-01,0,6,0,60,57,1
山东,2020-03-02,0,1,0,60,58,1
山东,2020-03-11,1,1,0,61,59,1
山东,2020-03-22,0,1,0,61,60,1
山东,2020-04-07,2,0,0,63,60,1
山东,2020-04-16,2,0,0,65,60,1
山东,2020-05-05,0,1,0,65,61,1
山东,2020-05-10,0,1,0,65,62,1
山东,2020-05-15,0,2,0,65,64,1
广东,2020-01-21,2,0,0,2,0,0
广东,2020-01-23,1,0,0,3,0,0
广东,2020-01-26,1,0,0,4,0,0
广东,2020-02-01,1,0,0,5,0,0
广东,2020-02-03,1,0,0,6,0,0
广东,2020-02-04,0,1,0,6,1,0
广东,2020-02-08,0,1,0,6,2,0
广东,2020-02-10,1,1,0,7,3,0
广东,2020-02-12,1,0,0,8,3,0
广东,2020-02-14,2,0,0,10,3,0
广东,2020-02-15,0,1,0,10,4,0
广东,2020-02-18,0,1,0,10,5,0
广东,2020-02-21,0,1,0,10,6,0
广东,2020-02-25,0,1,0,10,7,0
广东,2020-03-08,0,0,1,10,7,1
台湾,2020-01-21,1,0,0,1,0,0
台湾,2020-01-24,2,0,0,3,0,0
台湾,2020-01-26,1,0,0,4,0,0
台湾,2020-01-27,1,0,0,5,0,0
台湾,2020-01-28,3,0,0,8,0,0
台湾,2020-01-30,1,0,0,9,0,0
台湾,2020-01-31,1,0,0,10,0,0
台湾,2020-02-04,1,0,0,11,0,0
台湾,2020-02-06,5,1,0,16,1,0
台湾,2020-02-08,1,0,0,17,1,0
台湾,2020-02-09,1,0,0,18,1,0
台湾,2020-02-15,0,1,0,18,2,0
台湾,2020-02-16,2,0,1,20,2,1
台湾,2020-02-17,2,0,0,22,2,1
台湾,2020-02-19,2,0,0,24,2,1
台湾,2020-02-21,2,0,0,26,2,1
台湾,2020-02-23,2,3,0,28,5,1
台湾,2020-02-24,2,0,0,30,5,1
台湾,2020-02-25,1,0,0,31,5,1
台湾,2020-02-26,1,0,0,32,5,1
台湾,2020-02-27,0,1,0,32,6,1
台湾,2020-02-28,2,3,0,34,9,1
台湾,2020-02-29,5,0,0,39,9,1
台湾,2020-03-01,1,3,0,40,12,1
台湾,2020-03-02,1,0,0,41,12,1
台湾,2020-03-03,1,0,0,42,12,1
台湾,2020-03-05,2,0,0,44,12,1
台湾,2020-03-06,1,0,0,45,12,1
台湾,2020-03-07,0,1,0,45,13,1
台湾,2020-03-08,0,2,0,45,15,1
台湾,2020-03-10,2,2,0,47,17,1
台湾,2020-03-11,1,0,0,48,17,1
台湾,2020-03-12,1,3,0,49,20,1
台湾,2020-03-13,1,0,0,50,20,1
台湾,2020-03-14,3,0,0,53,20,1
台湾,2020-03-15,6,0,0,59,20,1
台湾,2020-03-16,8,2,0,67,22,1
台湾,2020-03-17,10,0,0,77,22,1
台湾,2020-03-18,23,0,0,100,22,1
台湾,2020-03-19,8,4,0,108,26,1
台湾,2020-03-20,27,2,1,135,28,2
台湾,2020-03-21,18,0,0,153,28,2
台湾,2020-03-22,16,0,0,169,28,2
台湾,2020-03-23,26,1,0,195,29,2
台湾,2020-03-24,21,0,0,216,29,2
台湾,2020-03-25,19,0,0,235,29,2
台湾,2020-03-26,17,0,0,252,29,2
台湾,2020-03-27,15,1,0,267,30,2
台湾,2020-03-28,16,0,0,283,30,2
台湾,2020-03-29,15,9,1,298,39,3
台湾,2020-03-30,8,0,2,306,39,5
台湾,2020-03-31,16,0,0,322,39,5
台湾,2020-04-01,7,6,0,329,45,5
台湾,2020-04-02,10,5,0,339,50,5
台湾,2020-04-03,9,0,0,348,50,5
台湾,2020-04-04,7,0,0,355,50,5
台湾,2020-04-05,8,4,0,363,54,5
台湾,2020-04-06,10,3,0,373,57,5
台湾,2020-04-07,3,4,0,376,61,5
台湾,2020-04-08,3,6,0,379,67,5
台湾,2020-04-09,1,13,0,380,80,5
台湾,2020-04-10,2,11,1,382,91,6
台湾,2020-04-11,3,8,0,385,99,6
台湾,2020-04-12,3,10,0,388,109,6
台湾,2020-04-13,5,5,0,393,114,6
台湾,2020-04-14,0,10,0,393,124,6
台湾,2020-04-15,2,13,0,395,137,6
台湾,2020-04-16,0,18,0,395,155,6
台湾,2020-04-17,0,11,0,395,166,6
台湾,2020-04-18,3,12,0,398,178,6
台湾,2020-04-19,22,11,0,420,189,6
台湾,2020-04-20,2,14,0,422,203,6
台湾,2020-04-21,3,14,0,425,217,6
台湾,2020-04-22,1,19,0,426,236,6
台湾,2020-04-23,1,17,0,427,253,6
台湾,2020-04-24,1,11,0,428,264,6
台湾,2020-04-25,1,11,0,429,275,6
台湾,2020-04-26,0,6,0,429,281,6
台湾,2020-04-27,0,9,0,429,290,6
台湾,2020-04-28,0,17,0,429,307,6
台湾,2020-04-29,0,4,0,429,311,6
台湾,2020-04-30,0,11,0,429,322,6
台湾,2020-05-01,0,2,0,429,324,6
台湾,2020-05-02,3,0,0,432,324,6
台湾,2020-05-03,4,8,0,436,332,6
台湾,2020-05-04,2,2,0,438,334,6
台湾,2020-05-06,1,5,0,439,339,6
台湾,2020-05-07,1,8,0,440,347,6
台湾,2020-05-08,0,8,0,440,355,6
台湾,2020-05-09,0,6,0,440,361,6
台湾,2020-05-10,0,5,0,440,366,6
台湾,2020-05-11,0,2,1,440,368,7
台湾,2020-05-12,0,4,0,440,372,7
台湾,2020-05-13,0,3,0,440,375,7
台湾,2020-05-14,0,8,0,440,383,7
台湾,2020-05-15,0,4,0,440,387,7
台湾,2020-05-16,0,2,0,440,389,7
台湾,2020-05-17,0,6,0,440,395,7
台湾,2020-05-18,0,3,0,440,398,7
台湾,2020-05-19,0,3,0,440,401,7
台湾,2020-05-20,0,1,0,440,402,7
台湾,2020-05-21,1,5,0,441,407,7
台湾,2020-05-22,0,1,0,441,408,7
台湾,2020-05-23,0,3,0,441,411,7
台湾,2020-05-24,0,3,0,441,414,7
台湾,2020-05-25,0,1,0,441,415,7
台湾,2020-05-26,0,1,0,441,416,7
台湾,2020-05-27,0,3,0,441,419,7
台湾,2020-05-28,0,1,0,441,420,7
台湾,2020-05-29,1,0,0,442,420,7
台湾,2020-05-30,0,1,0,442,421,7
台湾,2020-05-31,0,2,0,442,423,7
台湾,2020-06-01,1,4,0,443,427,7
台湾,2020-06-03,0,1,0,443,428,7
台湾,2020-06-05,0,1,0,443,429,7
台湾,2020-06-07,0,1,0,443,430,7
台湾,2020-06-09,0,1,0,443,431,7
台湾,2020-06-15,2,2,0,445,433,7
台湾,2020-06-17,0,1,0,445,434,7
台湾,2020-06-18,1,0,0,446,434,7
台湾,2020-06-22,0,1,0,446,435,7
台湾,2020-06-25,1,0,0,447,435,7
北京,2020-01-21,1,0,0,1,0,0
北京,2020-01-23,1,0,0,2,0,0
北京,2020-01-24,1,0,0,3,0,0
北京,2020-01-25,1,0,0,4,0,0
北京,2020-01-26,2,0,0,6,0,0
北京,2020-01-27,1,0,0,7,0,0
北京,2020-01-29,1,0,0,8,0,0
北京,2020-01-30,4,0,0,12,0,0
北京,2020-01-31,1,0,0,13,0,0
北京,2020-02-06,1,0,0,14,0,0
北京,2020-02-07,1,0,0,15,0,0
北京,2020-02-08,1,0,0,16,0,0
北京,2020-02-10,1,0,0,17,0,0
北京,2020-02-15,1,0,0,18,0,0
北京,2020-02-19,1,0,0,19,0,0
北京,2020-06-20,1,0,0,20,0,0
重庆,2020-01-21,2,0,0,2,0,0
重庆,2020-01-23,1,0,0,3,0,0
重庆,2020-01-24,7,0,0,10,0,0
重庆,2020-01-25,3,0,0,13,0,0
重庆,2020-01-26,1,0,0,14,0,0
重庆,2020-01-27,1,0,0,15,0,0
重庆,2020-01-28,2,0,0,17,0,0
重庆,2020-01-29,7,0,0,24,0,0
重庆,2020-01-30,4,0,0,28,0,0
重庆,2020-01-31,5,0,0,33,0,0
重庆,2020-02-01,6,0,0,39,0,0
重庆,2020-02-02,10,0,1,49,0,1
重庆,2020-02-03,7,0,0,56,0,1
重庆,2020-02-04,9,1,0,65,1,1
重庆,2020-02-05,3,1,0,68,2,1
重庆,2020-02-06,5,0,0,73,2,1
重庆,2020-02-07,5,2,0,78,4,1
重庆,2020-02-08,6,1,0,84,5,1
重庆,2020-02-09,13,3,0,97,8,1
重庆,2020-02-10,1,3,0,98,11,1
重庆,2020-02-11,3,3,0,101,14,1
重庆,2020-02-12,2,2,0,103,16,1
重庆,2020-02-13,0,7,1,103,23,2
重庆,2020-02-14,1,4,1,104,27,3
重庆,2020-02-15,1,7,0,105,34,3
重庆,2020-02-16,3,1,0,108,35,3
重庆,2020-02-17,0,1,0,108,36,3
重庆,2020-02-18,2,5,0,110,41,3
重庆,2020-02-19,3,5,0,113,46,3
重庆,2020-02-20,2,10,1,115,56,4
重庆,2020-02-21,3,9,0,118,65,4
重庆,2020-02-22,0,1,0,118,66,4
重庆,2020-02-24,0,6,0,118,72,4
重庆,2020-02-25,0,3,0,118,75,4
重庆,2020-02-26,0,4,0,118,79,4
重庆,2020-02-27,0,2,0,118,81,4
重庆,2020-02-28,0,3,0,118,84,4
重庆,2020-02-29,0,3,0,118,87,4
重庆,2020-03-01,0,2,0,118,89,4
重庆,2020-03-02,0,9,0,118,98,4
重庆,2020-03-03,0,5,0,118,103,4
重庆,2020-03-04,0,3,0,118,106,4
重庆,2020-03-06,0,2,0,118,108,4
重庆,2020-03-07,0,1,0,118,109,4
重庆,2020-03-09,0,2,0,118,111,4
重庆,2020-03-10,0,1,0,118,112,4
重庆,2020-03-11,0,2,0,118,114,4
山东,2020-01-21,1,0,0,1,0,0
山东,2020-01-23,1,0,0,2,0,0
山东,2020-01-24,1,0,0,3,0,0
山东,2020-01-25,1,0,0,4,0,0
山东,2020-01-26,3,0,0,7,0,0
山东,2020-01-27,3,0,0,10,0,0
山东,2020-01-28,1,0,0,11,0,0
山东,2020-01-29,3,0,0,14,0,0
山东,2020-01-30,5,0,0,19,0,0
山东,2020-01-31,5,0,0,24,0,0
山东,2020-02-01,0,2,0,24,2,0
山东,2020-02-02,1,0,0,25,2,0
山东,2020-02-04,2,0,0,27,2,0
山东,2020-02-05,1,3,0,28,5,0
山东,2020-02-06,2,0,0,30,5,0
山东,2020-02-07,2,0,0,32,5,0
山东,2020-02-08,2,3,0,34,8,0
山东,2020-02-09,1,0,0,35,8,0
山东,2020-02-10,2,0,0,37,8,0
山东,2020-02-11,1,0,0,38,8,0
山东,2020-02-12,0,1,0,38,9,0
山东,2020-02-18,0,1,0,38,10,0
山东,2020-02-19,0,1,0,38,11,0
山东,2020-02-20,0,5,0,38,16,0
山东,2020-02-21,0,4,0,38,20,0
山东,2020-02-22,0,1,0,38,21,0
山东,2020-02-23,0,1,0,38,22,0
山东,2020-02-24,0,3,0,38,25,0
山东,2020-02-25,0,2,0,38,27,0
山东,2020-02-27,0,1,0,38,28,0
山东,2020-02-29,0,3,0,38,31,0
山东,2020-03-01,0,2,0,38,33,0
山东,2020-03-02,0,1,0,38,34,0
山东,2020-03-05,0,1,0,38,35,0
山东,2020-03-10,0,1,0,38,36,0
山东,2020-03-12,0,1,1,38,37,1
重庆,2020-01-21,2,0,0,2,0,0
重庆,2020-01-23,1,0,0,3,0,0
重庆,2020-01-26,2,0,0,5,0,0
重庆,2020-01-29,0,1,0,5,1,0
重庆,2020-01-30,1,0,0,6,1,0
重庆,2020-02-02,1,2,0,7,3,0
重庆,2020-02-03,0,1,0,7,4,0
重庆,2020-02-04,1,0,0,8,4,0
重庆,2020-02-09,1,0,0,9,4,0
重庆,2020-02-10,1,0,0,10,4,0
重庆,2020-02-13,0,1,0,10,5,0
重庆,2020-02-18,0,1,0,10,6,0
重庆,2020-02-24,0,1,0,10,7,0
重庆,2020-02-25,0,1,0,10,8,0
重庆,2020-02-29,0,1,0,10,9,0
重庆,2020-03-03,0,1,0,10,10,0
北京,2020-01-21,1,0,0,1,0,0
北京,2020-01-22,1,0,0,2,0,0
北京,2020-01-23,1,0,0,3,0,0
北京,2020-01-24,1,0,0,4,0,0
北京,2020-01-25,1,0,0,5,0,0
北京,2020-01-26,2,0,0,7,0,0
北京,2020-01-27,1,0,0,8,0,0
北京,2020-01-28,1,0,0,9,0,0
北京,2020-01-29,3,0,0,12,0,0
北京,2020-01-30,1,0,0,13,0,0
北京,2020-01-31,4,0,0,17,0,0
北京,2020-02-02,9,0,0,26,0,0
北京,2020-02-03,2,0,0,28,0,0
北京,2020-02-04,1,0,0,29,0,0
北京,2020-02-05,5,0,0,34,0,0
北京,2020-02-06,2,0,0,36,0,0
北京,2020-02-07,1,0,0,37,0,0
北京,2020-02-08,1,0,0,38,0,0
北京,2020-02-09,1,0,0,39,0,0
北京,2020-02-11,3,0,0,42,0,0
北京,2020-02-12,3,0,0,45,0,0
北京,2020-02-15,1,0,0,46,0,0
北京,2020-02-17,1,0,0,47,0,0
北京,2020-02-18,5,0,0,52,0,0
北京,2020-02-19,1,0,0,53,0,0
北京,2020-06-11,1,0,0,54,0,0
北京,2020-06-13,1,0,0,55,0,0
北京,2020-06-16,1,0,0,56,0,0
北京,2020-06-18,1,0,0,57,0,0
北京,2020-06-21,1,0,0,58,0,0
北京,2020-06-22,1,0,0,59,0,0
天津,2020-01-21,1,0,0,1,0,0
天津,2020-01-28,1,0,0,2,0,0
天津,2020-02-03,1,0,0,3,0,0
天津,2020-02-06,1,0,0,4,0,0
天津,2020-02-11,0,1,0,4,1,0
天津,2020-02-12,0,1,0,4,2,0
天津,2020-02-16,0,1,0,4,3,0
天津,2020-02-18,0,1,0,4,4,0
宁夏,2020-01-21,1,0,0,1,0,0
宁夏,2020-01-25,1,0,0,2,0,0
宁夏,2020-01-26,3,0,0,5,0,0
宁夏,2020-01-27,2,0,0,7,0,0
宁夏,2020-01-29,2,0,0,9,0,0
宁夏,2020-01-30,2,0,0,11,0,0
宁夏,2020-01-31,4,0,0,15,0,0
宁夏,2020-02-01,1,0,0,16,0,0
宁夏,2020-02-02,3,0,0,19,0,0
宁夏,2020-02-03,1,1,0,20,1,0
宁夏,2020-02-05,5,0,0,25,1,0
宁夏,2020-02-06,2,0,0,27,1,0
宁夏,2020-02-07,1,2,0,28,3,0
宁夏,2020-02-08,0,2,0,28,5,0
宁夏,2020-02-10,2,0,0,30,5,0
宁夏,2020-02-11,1,5,0,31,10,0
宁夏,2020-02-12,1,2,0,32,12,0
宁夏,2020-02-14,1,3,0,33,15,0
宁夏,2020-02-15,0,5,0,33,20,0
宁夏,2020-02-17,0,2,0,33,22,0
宁夏,2020-02-18,0,3,0,33,25,0
宁夏,2020-02-20,0,2,0,33,27,0
宁夏,2020-02-21,0,1,0,33,28,0
宁夏,2020-02-23,0,1,0,33,29,0
宁夏,2020-02-25,0,1,0,33,30,0
宁夏,2020-02-27,0,2,0,33,32,0
宁夏,2020-03-03,1,0,0,34,32,0
宁夏,2020-03-14,0,1,0,34,33,0
宁夏,2020-03-16,0,1,0,34,34,0
湖南,2020-01-21,1,0,0,1,0,0
湖南,2020-01-22,3,0,0,4,0,0
湖南,2020-01-23,4,0,0,8,0,0
湖南,2020-01-25,10,0,0,18,0,0
湖南,2020-01-26,4,0,0,22,0,0
湖南,2020-01-27,2,0,0,24,0,0
湖南,2020-01-28,22,0,0,46,0,0
湖南,2020-01-29,11,0,0,57,0,0
湖南,2020-01-30,11,1,0,68,1,0
湖南,2020-01-31,18,0,0,86,1,0
湖南,2020-02-01,26,1,0,112,2,0
湖南,2020-02-02,13,0,0,125,2,0
湖南,2020-02-03,23,0,0,148,2,0
湖南,2020-02-04,16,4,0,164,6,0
湖南,2020-02-05,15,2,0,179,8,0
湖南,2020-02-06,11,2,0,190,10,0
湖南,2020-02-07,6,9,0,196,19,0
湖南,2020-02-08,9,8,0,205,27,0
湖南,2020-02-09,8,6,0,213,33,0
湖南,2020-02-10,6,6,0,219,39,0
湖南,2020-02-11,4,9,0,223,48,0
湖南,2020-02-12,5,9,0,228,57,0
湖南,2020-02-13,10,6,0,238,63,0
湖南,2020-02-14,3,3,0,241,66,0
湖南,2020-02-15,0,7,1,241,73,1
湖南,2020-02-16,0,15,0,241,88,1
湖南,2020-02-17,0,4,1,241,92,2
湖南,2020-02-18,0,6,0,241,98,2
湖南,2020-02-19,1,12,0,242,110,2
湖南,2020-02-20,0,15,0,242,125,2
湖南,2020-02-21,0,5,0,242,130,2
湖南,2020-02-22,0,11,0,242,141,2
湖南,2020-02-23,0,2,0,242,143,2
湖南,2020-02-24,0,9,0,242,152,2
湖南,2020-02-25,0,7,0,242,159,2
湖南,2020-02-26,0,5,0,242,164,2
湖南,2020-02-27,0,8,0,242,172,2
湖南,2020-02-28,0,2,0,242,174,2
湖南,2020-02-29,0,4,0,242,178,2
湖南,2020-03-01,0,7,0,242,185,2
湖南,2020-03-02,0,1,0,242,186,2
湖南,2020-03-03,0,6,0,242,192,2
湖南,2020-03-04,0,9,0,242,201,2
湖南,2020-03-05,0,6,0,242,207,2
湖南,2020-03-06,0,2,0,242,209,2
湖南,2020-03-07,0,4,0,242,213,2
湖南,2020-03-08,0,3,0,242,216,2
湖南,2020-03-09,0,8,0,242,224,2
湖南,2020-03-10,0,5,0,242,229,2
湖南,2020-03-11,0,3,0,242,232,2
湖南,2020-03-12,0,4,0,242,236,2
湖南,2020-03-13,0,2,0,242,238,2
湖南,2020-03-14,0,2,0,242,240,2
重庆,2020-01-21,1,0,0,1,0,0
重庆,2020-01-23,2,0,0,3,0,0
重庆,2020-01-24,2,0,0,5,0,0
重庆,2020-01-26,1,0,0,6,0,0
重庆,2020-01-27,1,0,0,7,0,0
重庆,2020-01-30,1,0,0,8,0,0
重庆,2020-01-31,2,0,0,10,0,0
重庆,2020-02-02,1,0,0,11,0,0
重庆,2020-02-03,1,0,0,12,0,0
重庆,2020-02-06,0,2,0,12,2,0
重庆,2020-02-08,3,0,0,15,2,0
重庆,2020-02-09,0,1,0,15,3,0
重庆,2020-02-10,1,0,0,16,3,0
重庆,2020-02-12,1,5,0,17,8,0
重庆,2020-02-14,1,0,0,18,8,0
重庆,2020-02-15,2,1,0,20,9,0
重庆,2020-02-16,1,0,0,21,9,0
重庆,2020-02-18,0,1,0,21,10,0
重庆,2020-02-20,0,1,0,21,11,0
重庆,2020-02-23,1,0,0,22,11,0
重庆,2020-02-25,0,2,0,22,13,0
重庆,2020-02-26,0,1,0,22,14,0
重庆,2020-03-02,0,1,0,22,15,0
重庆,2020-03-05,0,1,0,22,16,0
重庆,2020-03-06,0,1,0,22,17,0
重庆,2020-03-07,0,1,0,22,18,0
重庆,2020-03-11,0,1,0,22,19,0
重庆,2020-03-13,0,2,0,22,21,0
重庆,2020-03-15,0,1,0,22,22,0
河南,2020-01-21,1,0,0,1,0,0
河南,2020-01-22,2,0,0,3,0,0
河南,2020-01-23,2,0,0,5,0,0
河南,2020-01-24,3,0,0,8,0,0
河南,2020-01-25,12,0,0,20,0,0
河南,2020-01-26,9,0,0,29,0,0
河南,2020-01-27,8,0,0,37,0,0
河南,2020-01-28,3,1,0,40,1,0
河南,2020-01-29,6,1,0,46,2,0
河南,2020-01-30,4,1,0,50,3,0
河南,2020-01-31,6,0,0,56,3,0
河南,2020-02-01,9,0,0,65,3,0
河南,2020-02-02,7,3,0,72,6,0
河南,2020-02-03,13,0,0,85,6,0
河南,2020-02-04,7,5,0,92,11,0
河南,2020-02-05,10,6,0,102,17,0
河南,2020-02-06,10,10,0,112,27,0
河南,2020-02-07,8,1,0,120,28,0
河南,2020-02-08,6,2,0,126,30,0
河南,2020-02-09,4,10,0,130,40,0
河南,2020-02-10,2,0,0,132,40,0
河南,2020-02-11,5,0,1,137,40,1
河南,2020-02-12,4,3,0,141,43,1
河南,2020-02-13,1,0,0,142,43,1
河南,2020-02-14,2,3,0,144,46,1
河南,2020-02-15,4,0,0,148,46,1
河南,2020-02-16,3,0,0,151,46,1
河南,2020-02-17,3,12,0,154,58,1
河南,2020-02-18,2,0,0,156,58,1
河南,2020-02-19,1,0,0,157,58,1
河南,2020-03-10,1,15,0,158,73,1
河南,2020-03-12,1,4,1,159,77,2
河南,2020-03-13,1,6,0,160,83,2
河南,2020-03-14,1,10,0,161,93,2
澳门,2020-01-22,1,0,0,1,0,0
澳门,2020-01-23,1,0,0,2,0,0
澳门,2020-01-26,3,0,0,5,0,0
澳门,2020-01-27,2,0,0,7,0,0
澳门,2020-02-02,1,0,0,8,0,0
澳门,2020-02-03,2,0,0,10,0,0
澳门,2020-02-06,0,1,0,10,1,0
澳门,2020-02-12,0,1,0,10,2,0
澳门,2020-02-13,0,1,0,10,3,0
澳门,2020-02-16,0,2,0,10,5,0
澳门,2020-02-19,0,1,0,10,6,0
澳门,2020-02-25,0,1,0,10,7,0
澳门,2020-02-27,0,1,0,10,8,0
澳门,2020-03-03,0,1,0,10,9,0
澳门,2020-03-06,0,1,0,10,10,0
澳门,2020-03-16,1,0,0,11,10,0
澳门,2020-03-17,2,0,0,13,10,0
澳门,2020-03-18,2,0,0,15,10,0
澳门,2020-03-19,2,0,0,17,10,0
澳门,2020-03-21,1,0,0,18,10,0
澳门,2020-03-22,3,0,0,21,10,0
澳门,2020-03-23,4,0,0,25,10,0
澳门,2020-03-24,1,0,0,26,10,0
澳门,2020-03-25,4,0,0,30,10,0
澳门,2020-03-26,3,0,0,33,10,0
澳门,2020-03-27,1,0,0,34,10,0
澳门,2020-03-28,3,0,0,37,10,0
澳门,2020-03-29,1,0,0,38,10,0
澳门,2020-03-30,1,0,0,39,10,0
澳门,2020-03-31,2,0,0,41,10,0
澳门,2020-04-03,2,0,0,43,10,0
澳门,2020-04-04,1,0,0,44,10,0
澳门,2020-04-08,1,0,0,45,10,0
澳门,2020-04-12,0,3,0,45,13,0
澳门,2020-04-14,0,2,0,45,15,0
澳门,2020-04-15,0,1,0,45,16,0
澳门,2020-04-17,0,1,0,45,17,0
澳门,2020-04-19,0,3,0,45,20,0
澳门,2020-04-20,0,2,0,45,22,0
澳门,2020-04-21,0,2,0,45,24,0
澳门,2020-04-22,0,2,0,45,26,0
澳门,2020-04-23,0,1,0,45,27,0
澳门,2020-04-25,0,1,0,45,28,0
澳门,2020-04-26,0,3,0,45,31,0
澳门,2020-04-27,0,1,0,45,32,0
澳门,2020-04-28,0,1,0,45,33,0
澳门,2020-04-29,0,1,0,45,34,0
澳门,2020-04-30,0,1,0,45,35,0
澳门,2020-05-01,0,2,0,45,37,0
澳门,2020-05-02,0,1,0,45,38,0
澳门,2020-05-03,0,1,0,45,39,0
澳门,2020-05-06,0,1,0,45,40,0
澳门,2020-05-10,0,1,0,45,41,0
澳门,2020-05-11,0,1,0,45,42,0
澳门,2020-05-13,0,1,0,45,43,0
澳门,2020-05-16,0,1,0,45,44,0
澳门,2020-05-19,0,1,0,45,45,0
甘肃,2020-01-22,1,0,0,1,0,0
甘肃,2020-02-05,1,0,0,2,0,0
甘肃,2020-02-06,2,0,0,4,0,0
甘肃,2020-02-15,0,1,0,4,1,0
甘肃,2020-02-20,0,1,0,4,2,0
甘肃,2020-02-21,0,1,0,4,3,0
甘肃,2020-02-27,0,1,0,4,4,0
广西,2020-01-22,3,0,0,3,0,0
广西,2020-01-23,3,0,0,6,0,0
广西,2020-01-25,1,0,0,7,0,0
广西,2020-01-26,2,0,0,9,0,0
广西,2020-01-27,2,0,0,11,0,0
广西,2020-01-28,2,0,0,13,0,0
广西,2020-01-29,2,0,0,15,0,0
广西,2020-01-30,2,0,0,17,0,0
广西,2020-01-31,6,0,0,23,0,0
广西,2020-02-02,3,0,0,26,0,0
广西,2020-02-03,1,0,0,27,0,0
广西,2020-02-04,2,2,0,29,2,0
广西,2020-02-05,2,0,0,31,2,0
广西,2020-02-06,0,1,0,31,3,0
广西,2020-02-07,1,0,0,32,3,0
广西,2020-02-08,1,0,0,33,3,0
广西,2020-02-09,2,0,0,35,3,0
广西,2020-02-10,1,1,0,36,4,0
广西,2020-02-11,3,0,0,39,4,0
广西,2020-02-12,0,0,1,39,4,1
广西,2020-02-13,1,0,0,40,4,1
广西,2020-02-14,3,3,0,43,7,1
广西,2020-02-16,0,2,0,43,9,1
广西,2020-02-17,1,1,0,44,10,1
广西,2020-02-18,0,4,0,44,14,1
广西,2020-02-24,0,7,0,44,21,1
广西,2020-02-25,0,3,0,44,24,1
广西,2020-02-26,0,5,0,44,29,1
广西,2020-02-27,0,3,0,44,32,1
广西,2020-02-28,0,1,0,44,33,1
广西,2020-03-01,0,2,0,44,35,1
广西,2020-03-02,0,2,0,44,37,1
广西,2020-03-04,0,1,0,44,38,1
广西,2020-03-07,0,1,0,44,39,1
广西,2020-03-08,0,1,0,44,40,1
广西,2020-03-11,0,1,0,44,41,1
安徽,2020-01-22,1,0,0,1,0,0
安徽,2020-01-24,3,0,0,4,0,0
安徽,2020-01-25,2,0,0,6,0,0
安徽,2020-01-27,2,0,0,8,0,0
安徽,2020-01-28,7,0,0,15,0,0
安徽,2020-01-29,5,1,0,20,1,0
安徽,2020-01-31,5,0,0,25,1,0
安徽,2020-02-01,5,1,0,30,2,0
安徽,2020-02-02,9,0,0,39,2,0
安徽,2020-02-03,9,0,0,48,2,0
安徽,2020-02-04,10,0,0,58,2,0
安徽,2020-02-05,8,0,0,66,2,0
安徽,2020-02-06,6,3,0,72,5,0
安徽,2020-02-07,9,0,0,81,5,0
安徽,2020-02-08,6,0,0,87,5,0
安徽,2020-02-09,5,0,0,92,5,0
安徽,2020-02-10,0,2,0,92,7,0
安徽,2020-02-11,5,0,0,97,7,0
安徽,2020-02-12,3,5,0,100,12,0
安徽,2020-02-13,6,4,0,106,16,0
安徽,2020-02-14,1,3,0,107,19,0
安徽,2020-02-15,1,6,0,108,25,0
安徽,2020-02-16,0,10,0,108,35,0
安徽,2020-02-18,0,12,0,108,47,0
安徽,2020-02-19,0,11,0,108,58,0
安徽,2020-02-20,0,7,0,108,65,0
安徽,2020-02-21,0,5,0,108,70,0
安徽,2020-02-22,0,3,0,108,73,0
安徽,2020-02-23,0,7,0,108,80,0
安徽,2020-02-24,0,1,0,108,81,0
安徽,2020-02-25,0,6,0,108,87,0
安徽,2020-02-26,0,2,0,108,89,0
安徽,2020-02-27,0,10,0,108,99,0
安徽,2020-02-28,0,1,0,108,100,0
安徽,2020-02-29,0,1,0,108,101,0
安徽,2020-03-01,0,2,0,108,103,0
安徽,2020-03-02,0,4,0,108,107,0
安徽,2020-03-05,0,1,0,108,108,0
北京,2020-01-22,1,0,0,1,0,0
北京,2020-01-23,2,0,0,3,0,0
北京,2020-01-24,3,0,0,6,0,0
北京,2020-01-25,2,0,0,8,0,0
北京,2020-01-26,3,0,0,11,0,0
北京,2020-01-27,6,0,0,17,0,0
北京,2020-01-28,2,0,0,19,0,0
北京,2020-01-29,2,0,0,21,0,0
北京,2020-01-30,1,0,0,22,0,0
北京,2020-01-31,5,0,0,27,0,0
北京,2020-02-01,4,0,0,31,0,0
北京,2020-02-03,5,0,0,36,0,0
北京,2020-02-04,7,0,0,43,0,0
北京,2020-02-05,5,0,0,48,0,0
北京,2020-02-06,3,0,0,51,0,0
北京,2020-02-07,2,0,0,53,0,0
北京,2020-02-08,2,0,0,55,0,0
北京,2020-02-09,1,0,0,56,0,0
北京,2020-02-13,2,0,0,58,0,0
北京,2020-02-21,2,0,0,60,0,0
北京,2020-02-24,1,0,0,61,0,0
北京,2020-02-26,9,0,0,70,0,0
北京,2020-02-28,1,0,0,71,0,0
北京,2020-03-04,1,0,0,72,0,0
北京,2020-04-15,3,0,0,75,0,0
北京,2020-06-14,1,0,0,76,0,0
北京,2020-06-21,1,0,0,77,0,0
湖南,2020-01-22,1,0,0,1,0,0
湖南,2020-01-25,2,0,0,3,0,0
湖南,2020-01-26,3,0,0,6,0,0
湖南,2020-01-27,1,0,0,7,0,0
湖南,2020-01-29,3,0,0,10,0,0
湖南,2020-01-30,2,1,0,12,1,0
湖南,2020-01-31,1,0,0,13,1,0
湖南,2020-02-01,5,0,0,18,1,0
湖南,2020-02-02,3,0,0,21,1,0
湖南,2020-02-03,1,0,0,22,1,0
湖南,2020-02-04,2,0,0,24,1,0
湖南,2020-02-05,1,1,0,25,2,0
湖南,2020-02-06,4,2,0,29,4,0
湖南,2020-02-07,2,2,0,31,6,0
湖南,2020-02-08,1,2,0,32,8,0
湖南,2020-02-10,1,5,0,33,13,0
湖南,2020-02-11,5,1,0,38,14,0
湖南,2020-02-12,0,1,0,38,15,0
湖南,2020-02-13,1,0,0,39,15,0
湖南,2020-02-14,0,7,0,39,22,0
湖南,2020-02-17,0,4,0,39,26,0
湖南,2020-02-18,0,1,0,39,27,0
湖南,2020-02-19,0,2,0,39,29,0
湖南,2020-02-21,0,1,0,39,30,0
湖南,2020-02-22,0,1,0,39,31,0
湖南,2020-02-26,0,2,0,39,33,0
湖南,2020-02-27,0,1,0,39,34,0
湖南,2020-02-29,0,1,0,39,35,0
湖南,2020-03-03,0,1,0,39,36,0
湖南,2020-03-05,0,1,0,39,37,0
湖南,2020-03-06,0,1,0,39,38,0
安徽,2020-01-22,1,0,0,1,0,0
安徽,2020-01-24,1,0,0,2,0,0
安徽,2020-01-27,2,0,0,4,0,0
安徽,2020-01-31,2,0,0,6,0,0
安徽,2020-02-02,2,0,0,8,0,0
安徽,2020-02-03,3,2,0,11,2,0
安徽,2020-02-09,1,0,0,12,2,0
安徽,2020-02-10,0,1,0,12,3,0
安徽,2020-02-11,0,1,0,12,4,0
安徽,2020-02-12,1,0,0,13,4,0
安徽,2020-02-14,0,3,0,13,7,0
安徽,2020-02-20,0,1,0,13,8,0
安徽,2020-02-24,0,1,0,13,9,0
安徽,2020-02-27,0,1,0,13,10,0
安徽,2020-02-29,0,1,0,13,11,0
安徽,2020-03-03,0,1,0,13,12,0
安徽,2020-03-04,0,1,0,13,13,0
四川,2020-01-22,1,0,0,1,0,0
四川,2020-01-26,2,0,0,3,0,0
四川,2020-01-28,1,0,0,4,0,0
四川,2020-01-29,2,0,0,6,0,0
四川,2020-01-30,2,0,0,8,0,0
四川,2020-01-31,1,0,0,9,0,0
四川,2020-02-02,2,0,0,11,0,0
四川,2020-02-03,2,1,0,13,1,0
四川,2020-02-04,4,0,0,17,1,0
四川,2020-02-05,3,0,0,20,1,0
四川,2020-02-06,3,3,0,23,4,0
四川,2020-02-07,2,0,0,25,4,0
四川,2020-02-08,0,1,0,25,5,0
四川,2020-02-09,3,0,0,28,5,0
四川,2020-02-10,2,0,0,30,5,0
四川,2020-02-11,3,0,0,33,5,0
四川,2020-02-12,3,0,0,36,5,0
四川,2020-02-16,2,1,0,38,6,0
四川,2020-02-17,1,2,0,39,8,0
四川,2020-02-18,1,0,0,40,8,0
四川,2020-02-19,0,3,0,40,11,0
四川,2020-02-20,1,0,0,41,11,0
四川,2020-02-21,0,2,0,41,13,0
四川,2020-02-24,1,2,0,42,15,0
四川,2020-02-26,0,5,0,42,20,0
四川,2020-02-27,0,1,0,42,21,0
四川,2020-02-28,0,5,0,42,26,0
四川,2020-02-29,0,1,0,42,27,0
四川,2020-03-02,0,1,0,42,28,0
四川,2020-03-04,0,3,0,42,31,0
四川,2020-03-05,0,4,0,42,35,0
四川,2020-03-06,0,4,0,42,39,0
四川,2020-03-09,0,2,0,42,41,0
四川,2020-03-13,0,1,0,42,42,0
辽宁,2020-01-22,1,0,0,1,0,0
辽宁,2020-01-24,1,0,0,2,0,0
辽宁,2020-01-25,2,0,0,4,0,0
辽宁,2020-01-27,1,0,0,5,0,0
辽宁,2020-01-29,0,1,0,5,1,0
辽宁,2020-01-30,2,0,0,7,1,0
辽宁,2020-01-31,1,0,0,8,1,0
辽宁,2020-02-01,2,0,0,10,1,0
辽宁,2020-02-02,2,0,0,12,1,0
辽宁,2020-02-04,1,1,0,13,2,0
辽宁,2020-02-05,1,1,0,14,3,0
辽宁,2020-02-08,2,0,0,16,3,0
辽宁,2020-02-11,0,1,0,16,4,0
辽宁,2020-02-13,1,0,0,17,4,0
辽宁,2020-02-14,1,0,0,18,4,0
辽宁,2020-02-15,0,1,0,18,5,0
辽宁,2020-02-18,0,4,0,18,9,0
辽宁,2020-02-24,0,2,0,18,11,0
辽宁,2020-02-26,0,1,0,18,12,0
辽宁,2020-02-29,0,1,0,18,13,0
辽宁,2020-03-10,0,1,0,18,14,0
辽宁,2020-03-13,0,1,0,18,15,0
辽宁,2020-03-15,0,1,0,18,16,0
辽宁,2020-03-16,0,1,0,18,17,0
辽宁,2020-04-19,0,1,0,18,18,0
重庆,2020-01-22,1,0,0,1,0,0
重庆,2020-02-02,1,0,0,2,0,0
重庆,2020-02-04,1,0,0,3,0,0
重庆,2020-02-13,0,1,0,3,1,0
重庆,2020-02-17,0,1,0,3,2,0
重庆,2020-02-20,2,0,0,5,2,0
重庆,2020-02-28,0,1,0,5,3,0
重庆,2020-03-03,0,1,0,5,4,0
重庆,2020-03-07,0,1,0,5,5,0
福建,2020-01-22,1,0,0,1,0,0
福建,2020-01-23,1,0,0,2,0,0
福建,2020-01-24,3,0,0,5,0,0
福建,2020-01-25,1,0,0,6,0,0
福建,2020-01-26,7,0,0,13,0,0
福建,2020-01-27,5,0,0,18,0,0
福建,2020-01-28,6,0,0,24,0,0
福建,2020-01-29,6,0,0,30,0,0
福建,2020-01-30,2,0,0,32,0,0
福建,2020-01-31,7,0,0,39,0,0
福建,2020-02-01,5,0,0,44,0,0
福建,2020-02-02,3,0,0,47,0,0
福建,2020-02-03,6,0,0,53,0,0
福建,2020-02-04,2,2,0,55,2,0
福建,2020-02-05,1,2,0,56,4,0
福建,2020-02-06,1,2,0,57,6,0
福建,2020-02-07,2,1,0,59,7,0
福建,2020-02-08,3,3,0,62,10,0
福建,2020-02-09,1,1,0,63,11,0
福建,2020-02-10,0,1,0,63,12,0
福建,2020-02-11,1,1,0,64,13,0
福建,2020-02-12,0,2,0,64,15,0
福建,2020-02-13,2,2,0,66,17,0
福建,2020-02-14,0,1,0,66,18,0
福建,2020-02-15,2,2,0,68,20,0
福建,2020-02-16,1,3,0,69,23,0
福建,2020-02-17,2,3,0,71,26,0
福建,2020-02-18,0,2,0,71,28,0
福建,2020-02-19,0,5,1,71,33,1
福建,2020-02-20,0,3,0,71,36,1
福建,2020-02-21,0,11,0,71,47,1
福建,2020-02-22,0,3,0,71,50,1
福建,2020-02-23,0,3,0,71,53,1
福建,2020-02-24,0,3,0,71,56,1
福建,2020-02-25,0,5,0,71,61,1
福建,2020-02-26,1,4,0,72,65,1
福建,2020-02-27,0,2,0,72,67,1
福建,2020-02-28,0,2,0,72,69,1
福建,2020-02-29,0,1,0,72,70,1
福建,2020-03-05,0,1,0,72,71,1
安徽,2020-01-22,1,0,0,1,0,0
安徽,2020-01-23,1,0,0,2,0,0
安徽,2020-01-24,5,0,0,7,0,0
安徽,2020-01-25,3,0,0,10,0,0
安徽,2020-01-27,11,0,0,21,0,0
安徽,2020-01-28,2,0,0,23,0,0
安徽,2020-01-29,5,0,0,28,0,0
安徽,2020-01-30,10,0,0,38,0,0
安徽,2020-01-31,9,0,0,47,0,0
安徽,2020-02-01,12,0,0,59,0,0
安徽,2020-02-02,6,0,0,65,0,0
安徽,2020-02-03,14,0,0,79,0,0
安徽,2020-02-04,5,3,0,84,3,0
安徽,2020-02-05,11,0,0,95,3,0
安徽,2020-02-06,10,4,0,105,7,0
安徽,2020-02-07,8,2,0,113,9,0
安徽,2020-02-08,5,2,0,118,11,0
安徽,2020-02-09,7,2,0,125,13,0
安徽,2020-02-10,7,0,0,132,13,0
安徽,2020-02-11,6,4,0,138,17,0
安徽,2020-02-12,4,0,0,142,17,0
安徽,2020-02-13,4,6,0,146,23,0
安徽,2020-02-14,4,5,0,150,28,0
安徽,2020-02-15,2,4,0,152,32,0
安徽,2020-02-16,1,5,0,153,37,0
安徽,2020-02-17,1,4,0,154,41,0
安徽,2020-02-18,1,6,0,155,47,0
安徽,2020-02-19,0,17,0,155,64,0
安徽,2020-02-20,0,15,0,155,79,0
安徽,2020-02-21,0,11,0,155,90,0
安徽,2020-02-22,0,9,0,155,99,0
安徽,2020-02-23,0,3,0,155,102,0
安徽,2020-02-24,0,2,0,155,104,0
安徽,2020-02-25,0,5,0,155,109,0
安徽,2020-02-26,0,3,0,155,112,0
安徽,2020-02-27,0,7,0,155,119,0
安徽,2020-02-28,0,9,0,155,128,0
安徽,2020-02-29,0,6,0,155,134,0
安徽,2020-03-01,0,5,0,155,139,0
安徽,2020-03-02,0,6,0,155,145,0
安徽,2020-03-03,0,6,0,155,151,0
安徽,2020-03-04,0,4,0,155,155,0
贵州,2020-01-22,1,0,0,1,0,0
贵州,2020-01-28,0,1,0,1,1,0
贵州,2020-01-31,3,0,0,4,1,0
贵州,2020-02-01,2,0,0,6,1,0
贵州,2020-02-02,1,0,0,7,1,0
贵州,2020-02-03,3,0,0,10,1,0
贵州,2020-02-04,2,0,0,12,1,0
贵州,2020-02-05,3,0,0,15,1,0
贵州,2020-02-06,3,0,0,18,1,0
贵州,2020-02-08,4,0,0,22,1,0
贵州,2020-02-09,5,0,0,27,1,0
贵州,2020-02-10,2,0,0,29,1,0
贵州,2020-02-11,0,2,0,29,3,0
贵州,2020-02-12,4,0,0,33,3,0
贵州,2020-02-13,1,1,0,34,4,0
贵州,2020-02-15,0,2,0,34,6,0
贵州,2020-02-16,2,4,0,36,10,0
贵州,2020-02-17,0,3,0,36,13,0
贵州,2020-02-18,0,0,1,36,13,1
贵州,2020-02-19,0,1,0,36,14,1
贵州,2020-02-20,0,3,0,36,17,1
贵州,2020-02-21,0,1,0,36,18,1
贵州,2020-02-23,0,5,0,36,23,1
贵州,2020-02-26,0,4,0,36,27,1
贵州,2020-03-01,0,1,0,36,28,1
贵州,2020-03-09,0,1,0,36,29,1
贵州,2020-03-10,0,2,0,36,31,1
贵州,2020-03-11,0,1,0,36,32,1
贵州,2020-03-12,0,1,0,36,33,1
贵州,2020-03-13,0,1,0,36,34,1
贵州,2020-03-16,0,1,0,36,35,1
黑龙江,2020-01-22,1,0,0,1,0,0
黑龙江,2020-01-24,5,0,0,6,0,0
黑龙江,2020-01-25,2,0,0,8,0,0
黑龙江,2020-01-27,2,0,0,10,0,0
黑龙江,2020-01-28,1,0,0,11,0,0
黑龙江,2020-01-29,2,0,0,13,0,0
黑龙江,2020-01-30,5,0,0,18,0,0
黑龙江,2020-01-31,7,0,0,25,0,0
黑龙江,2020-02-01,9,2,0,34,2,0
黑龙江,2020-02-02,11,0,0,45,2,0
黑龙江,2020-02-03,18,0,0,63,2,0
黑龙江,2020-02-04,10,2,0,73,4,0
黑龙江,2020-02-05,9,2,0,82,6,0
黑龙江,2020-02-06,12,0,0,94,6,0
黑龙江,2020-02-07,6,3,0,100,9,0
黑龙江,2020-02-08,14,0,0,114,9,0
黑龙江,2020-02-09,14,0,0,128,9,0
黑龙江,2020-02-10,18,6,0,146,15,0
黑龙江,2020-02-11,4,0,0,150,15,0
黑龙江,2020-02-12,9,0,1,159,15,1
黑龙江,2020-02-13,5,0,2,164,15,3
黑龙江,2020-02-14,3,4,0,167,19,3
黑龙江,2020-02-15,15,11,0,182,30,3
黑龙江,2020-02-16,6,2,0,188,32,3
黑龙江,2020-02-17,2,0,0,190,32,3
黑龙江,2020-02-18,2,14,0,192,46,3
黑龙江,2020-02-19,2,2,0,194,48,3
黑龙江,2020-02-20,3,7,0,197,55,3
黑龙江,2020-02-21,0,20,0,197,75,3
黑龙江,2020-02-22,1,2,0,198,77,3
黑龙江,2020-02-26,0,1,1,198,78,4
黑龙江,2020-02-27,0,7,0,198,85,4
黑龙江,2020-02-28,0,9,0,198,94,4
黑龙江,2020-02-29,0,29,0,198,123,4
黑龙江,2020-03-01,0,17,0,198,140,4
黑龙江,2020-03-03,0,6,0,198,146,4
黑龙江,2020-03-04,0,2,0,198,148,4
黑龙江,2020-03-06,0,18,0,198,166,4
黑龙江,2020-03-07,0,2,0,198,168,4
黑龙江,2020-03-08,0,5,0,198,173,4
黑龙江,2020-03-09,0,5,0,198,178,4
黑龙江,2020-03-10,0,1,0,198,179,4
黑龙江,2020-03-11,0,3,0,198,182,4
黑龙江,2020-03-12,0,4,0,198,186,4
黑龙江,2020-03-14,0,1,0,198,187,4
黑龙江,2020-03-15,0,1,0,198,188,4
黑龙江,2020-03-16,0,1,0,198,189,4
黑龙江,2020-03-17,0,1,0,198,190,4
黑龙江,2020-03-19,0,2,0,198,192,4
黑龙江,2020-03-21,0,1,0,198,193,4
黑龙江,2020-03-23,0,1,0,198,194,4
黑龙江,2020-04-09,1,0,0,199,194,4
黑龙江,2020-04-10,1,0,0,200,194,4
黑龙江,2020-04-11,2,0,0,202,194,4
黑龙江,2020-04-12,7,0,0,209,194,4
黑龙江,2020-04-14,8,0,0,217,194,4
黑龙江,2020-04-15,4,0,0,221,194,4
黑龙江,2020-04-16,3,0,0,224,194,4
黑龙江,2020-04-17,7,1,0,231,195,4
黑龙江,2020-04-18,4,0,0,235,195,4
黑龙江,2020-04-19,3,0,0,238,195,4
黑龙江,2020-04-20,6,0,0,244,195,4
黑龙江,2020-04-21,7,0,0,251,195,4
黑龙江,2020-04-22,3,0,0,254,195,4
黑龙江,2020-04-23,2,0,0,256,195,4
黑龙江,2020-04-24,1,0,0,257,195,4
黑龙江,2020-04-25,2,0,0,259,195,4
黑龙江,2020-04-26,1,0,0,260,195,4
黑龙江,2020-04-27,3,0,0,263,195,4
黑龙江,2020-04-28,0,1,0,263,196,4
黑龙江,2020-05-02,0,13,0,263,209,4
黑龙江,2020-05-04,0,7,0,263,216,4
黑龙江,2020-05-05,0,5,0,263,221,4
黑龙江,2020-05-06,0,9,0,263,230,4
黑龙江,2020-05-07,0,7,0,263,237,4
黑龙江,2020-05-08,0,8,0,263,245,4
黑龙江,2020-05-09,1,8,0,264,253,4
黑龙江,2020-05-11,0,3,0,264,256,4
黑龙江,2020-05-12,0,1,0,264,257,4
黑龙江,2020-05-13,0,1,0,264,258,4
黑龙江,2020-05-15,0,1,0,264,259,4
黑龙江,2020-05-16,0,1,0,264,260,4
海南,2020-01-22,1,0,0,1,0,0
海南,2020-01-23,2,0,0,3,0,0
海南,2020-01-26,3,0,0,6,0,0
海南,2020-01-27,1,0,0,7,0,0
海南,2020-01-28,2,0,0,9,0,0
海南,2020-01-31,2,0,0,11,0,0
海南,2020-02-02,2,0,0,13,0,0
海南,2020-02-03,1,0,0,14,0,0
海南,2020-02-04,2,0,0,16,0,0
海南,2020-02-06,3,1,0,19,1,0
海南,2020-02-07,3,0,0,22,1,0
海南,2020-02-08,1,1,0,23,2,0
海南,2020-02-09,5,2,0,28,4,0
海南,2020-02-10,1,0,0,29,4,0
海南,2020-02-11,0,1,0,29,5,0
海南,2020-02-12,0,1,0,29,6,0
海南,2020-02-14,4,2,0,33,8,0
海南,2020-02-16,0,3,0,33,11,0
海南,2020-02-17,1,4,0,34,15,0
海南,2020-02-18,0,1,0,34,16,0
海南,2020-02-19,5,1,0,39,17,0
海南,2020-02-21,0,1,0,39,18,0
海南,2020-02-22,0,1,0,39,19,0
海南,2020-02-23,0,1,0,39,20,0
海南,2020-02-24,0,2,0,39,22,0
海南,2020-02-25,0,6,0,39,28,0
海南,2020-02-26,0,1,0,39,29,0
海南,2020-02-27,0,1,0,39,30,0
海南,2020-02-28,0,1,0,39,31,0
海南,2020-02-29,0,2,0,39,33,0
海南,2020-03-01,0,2,0,39,35,0
海南,2020-03-03,0,2,0,39,37,0
海南,2020-03-04,0,1,0,39,38,0
海南,2020-03-24,0,1,0,39,39,0
天津,2020-01-22,1,0,0,1,0,0
天津,2020-01-29,1,0,0,2,0,0
天津,2020-01-30,1,0,0,3,0,0
天津,2020-02-02,1,0,0,4,0,0
天津,2020-02-03,1,0,0,5,0,0
天津,2020-02-04,1,0,0,6,0,0
天津,2020-02-08,0,1,0,6,1,0
天津,2020-02-13,0,1,0,6,2,0
天津,2020-02-16,0,2,0,6,4,0
天津,2020-02-23,0,1,0,6,5,0
天津,2020-03-02,0,1,0,6,6,0
湖南,2020-01-22,3,0,0,3,0,0
湖南,2020-01-24,2,0,0,5,0,0
湖南,2020-01-25,3,0,0,8,0,0
湖南,2020-01-26,3,0,0,11,0,0
湖南,2020-01-27,5,0,0,16,0,0
湖南,2020-01-28,2,0,0,18,0,0
湖南,2020-01-29,5,0,0,23,0,0
湖南,2020-01-30,3,0,0,26,0,0
湖南,2020-01-31,2,1,0,28,1,0
湖南,2020-02-01,3,0,0,31,1,0
湖南,2020-02-02,1,0,0,32,1,0
湖南,2020-02-03,3,0,0,35,1,0
湖南,2020-02-04,0,1,0,35,2,0
湖南,2020-02-05,1,4,0,36,6,0
湖南,2020-02-06,2,1,0,38,7,0
湖南,2020-02-07,0,7,0,38,14,0
湖南,2020-02-08,1,1,0,39,15,0
湖南,2020-02-11,0,6,0,39,21,0
湖南,2020-02-13,0,5,0,39,26,0
湖南,2020-02-14,1,2,0,40,28,0
湖南,2020-02-15,0,2,0,40,30,0
湖南,2020-02-16,0,2,0,40,32,0
湖南,2020-02-17,0,2,0,40,34,0
湖南,2020-02-18,0,3,0,40,37,0
湖南,2020-02-19,0,1,0,40,38,0
湖南,2020-02-24,0,1,0,40,39,0
湖南,2020-02-26,0,1,0,40,40,0
浙江,2020-01-22,1,0,0,1,0,0
浙江,2020-01-24,1,0,0,2,0,0
浙江,2020-01-25,1,0,0,3,0,0
浙江,2020-01-26,2,0,0,5,0,0
浙江,2020-01-27,2,0,0,7,0,0
浙江,2020-01-28,6,0,0,13,0,0
浙江,2020-01-29,7,0,0,20,0,0
浙江,2020-01-30,7,0,0,27,0,0
浙江,2020-01-31,7,3,0,34,3,0
浙江,2020-02-02,2,3,0,36,6,0
浙江,2020-02-03,4,0,0,40,6,0
浙江,2020-02-04,4,0,0,44,6,0
浙江,2020-02-05,3,2,0,47,8,0
浙江,2020-02-06,1,1,0,48,9,0
浙江,2020-02-07,4,0,0,52,9,0
浙江,2020-02-08,1,4,0,53,13,0
浙江,2020-02-09,0,2,0,53,15,0
浙江,2020-02-10,0,1,0,53,16,0
浙江,2020-02-11,1,3,0,54,19,0
浙江,2020-02-12,1,4,0,55,23,0
浙江,2020-02-13,0,1,0,55,24,0
浙江,2020-02-17,0,6,0,55,30,0
浙江,2020-02-19,0,3,0,55,33,0
浙江,2020-02-20,0,3,0,55,36,0
浙江,2020-02-21,0,1,0,55,37,0
浙江,2020-02-22,0,2,0,55,39,0
浙江,2020-02-26,0,4,0,55,43,0
浙江,2020-02-27,0,7,0,55,50,0
浙江,2020-02-28,0,1,0,55,51,0
浙江,2020-03-01,0,1,0,55,52,0
浙江,2020-03-02,0,2,0,55,54,0
浙江,2020-03-10,0,1,0,55,55,0
湖北,2020-01-22,1,0,0,1,0,0
湖北,2020-01-23,7,0,0,8,0,0
湖北,2020-01-24,13,0,0,21,0,0
湖北,2020-01-25,17,0,1,38,0,1
湖北,2020-01-26,52,0,2,90,0,3
湖北,2020-01-27,24,0,0,114,0,3
湖北,2020-01-28,28,0,1,142,0,4
湖北,2020-01-29,49,0,0,191,0,4
湖北,2020-01-30,36,0,1,227,0,5
湖北,2020-01-31,24,1,0,251,1,5
湖北,2020-02-01,78,2,2,329,3,7
湖北,2020-02-02,16,3,4,345,6,11
湖北,2020-02-03,55,0,3,400,6,14
湖北,2020-02-04,22,10,2,422,16,16
湖北,2020-02-05,86,5,1,508,21,17
湖北,2020-02-06,45,3,0,553,24,17
湖北,2020-02-07,35,12,1,588,36,18
湖北,2020-02-08,41,12,1,629,48,19
湖北,2020-02-09,12,15,1,641,63,20
湖北,2020-02-10,15,6,1,656,69,21
湖北,2020-02-11,40,12,3,696,81,24
湖北,2020-02-12,190,11,0,886,92,24
湖北,2020-02-13,11,13,1,897,105,25
湖北,2020-02-14,4,7,3,901,112,28
湖北,2020-02-15,3,5,2,904,117,30
湖北,2020-02-16,4,15,3,908,132,33
湖北,2020-02-17,0,11,0,908,143,33
湖北,2020-02-18,1,38,0,909,181,33
湖北,2020-02-19,5,20,1,914,201,34
湖北,2020-02-20,0,28,3,914,229,37
湖北,2020-02-21,2,67,0,916,296,37
湖北,2020-02-22,4,65,0,920,361,37
湖北,2020-02-23,0,28,0,920,389,37
湖北,2020-02-24,0,43,0,920,432,37
湖北,2020-02-25,2,37,0,922,469,37
湖北,2020-02-26,1,39,0,923,508,37
湖北,2020-02-27,1,26,0,924,534,37
湖北,2020-02-28,0,29,0,924,563,37
湖北,2020-02-29,1,41,0,925,604,37
湖北,2020-03-01,2,18,2,927,622,39
湖北,2020-03-02,1,28,0,928,650,39
湖北,2020-03-03,0,14,0,928,664,39
湖北,2020-03-04,0,22,0,928,686,39
湖北,2020-03-05,0,16,0,928,702,39
湖北,2020-03-06,0,26,0,928,728,39
湖北,2020-03-07,0,15,0,928,743,39
湖北,2020-03-08,0,24,0,928,767,39
湖北,2020-03-09,0,22,0,928,789,39
湖北,2020-03-10,0,28,0,928,817,39
湖北,2020-03-11,0,17,0,928,834,39
湖北,2020-03-12,0,5,0,928,839,39
湖北,2020-03-13,0,21,0,928,860,39
湖北,2020-03-14,0,4,0,928,864,39
湖北,2020-03-15,0,1,0,928,865,39
湖北,2020-03-16,0,3,0,928,868,39
湖北,2020-03-17,0,2,0,928,870,39
湖北,2020-03-18,0,1,0,928,871,39
湖北,2020-03-19,0,4,0,928,875,39
湖北,2020-03-20,0,6,0,928,881,39
湖北,2020-03-21,0,3,0,928,884,39
湖北,2020-03-23,0,1,0,928,885,39
湖北,2020-03-24,0,1,0,928,886,39
湖北,2020-03-26,0,0,1,928,886,40
湖北,2020-03-27,0,1,0,928,887,40
湖北,2020-03-31,0,0,1,928,887,41
湖北,2020-01-22,6,0,0,6,0,0
湖北,2020-01-23,2,0,0,8,0,0
湖北,2020-01-24,2,0,0,10,0,0
湖北,2020-01-25,23,0,2,33,0,2
湖北,2020-01-26,14,0,0,47,0,2
湖北,2020-01-27,24,1,0,71,1,2
湖北,2020-01-28,30,0,0,101,1,2
湖北,2020-01-29,50,0,1,151,1,3
湖北,2020-01-30,70,0,0,221,1,3
湖北,2020-01-31,66,1,1,287,2,4
湖北,2020-02-01,46,0,0,333,2,4
湖北,2020-02-02,166,2,2,499,4,6
湖北,2020-02-03,114,3,1,613,7,7
湖北,2020-02-04,100,3,2,713,10,9
湖北,2020-02-05,88,9,1,801,19,10
湖北,2020-02-06,84,4,0,885,23,10
湖北,2020-02-07,56,7,1,941,30,11
湖北,2020-02-08,56,4,2,997,34,13
湖北,2020-02-09,48,12,2,1045,46,15
湖北,2020-02-10,30,10,2,1075,56,17
湖北,2020-02-11,35,24,4,1110,80,21
湖北,2020-02-12,321,22,2,1431,102,23
湖北,2020-02-13,16,57,4,1447,159,27
湖北,2020-02-14,31,33,5,1478,192,32
湖北,2020-02-15,12,71,4,1490,263,36
湖北,2020-02-16,11,42,1,1501,305,37
湖北,2020-02-17,36,34,1,1537,339,38
湖北,2020-02-18,4,70,0,1541,409,38
湖北,2020-02-19,12,42,2,1553,451,40
湖北,2020-02-20,7,80,0,1560,531,40
湖北,2020-02-21,6,81,0,1566,612,40
湖北,2020-02-22,8,69,1,1574,681,41
湖北,2020-02-23,0,53,1,1574,734,42
湖北,2020-02-24,2,42,0,1576,776,42
湖北,2020-02-25,1,46,2,1577,822,44
湖北,2020-02-26,2,45,1,1579,867,45
湖北,2020-02-27,0,46,1,1579,913,46
湖北,2020-02-28,0,52,0,1579,965,46
湖北,2020-02-29,0,69,0,1579,1034,46
湖北,2020-03-01,1,62,2,1580,1096,48
湖北,2020-03-02,0,48,0,1580,1144,48
湖北,2020-03-03,0,71,0,1580,1215,48
湖北,2020-03-04,0,54,0,1580,1269,48
湖北,2020-03-05,0,57,0,1580,1326,48
湖北,2020-03-06,0,24,0,1580,1350,48
湖北,2020-03-07,0,26,1,1580,1376,49
湖北,2020-03-08,0,34,0,1580,1410,49
湖北,2020-03-09,0,21,0,1580,1431,49
湖北,2020-03-10,0,11,0,1580,1442,49
湖北,2020-03-11,0,10,0,1580,1452,49
湖北,2020-03-12,0,12,0,1580,1464,49
湖北,2020-03-13,0,10,1,1580,1474,50
湖北,2020-03-14,0,9,0,1580,1483,50
湖北,2020-03-15,0,9,0,1580,1492,50
湖北,2020-03-16,0,6,0,1580,1498,50
湖北,2020-03-17,0,1,0,1580,1499,50
湖北,2020-03-18,0,3,0,1580,1502,50
湖北,2020-03-19,0,15,0,1580,1517,50
湖北,2020-03-20,0,6,1,1580,1523,51
湖北,2020-03-21,0,2,0,1580,1525,51
湖北,2020-03-23,0,1,0,1580,1526,51
湖北,2020-03-24,0,1,0,1580,1527,51
湖北,2020-03-25,0,0,1,1580,1527,52
湖北,2020-03-27,0,1,0,1580,1528,52
甘肃,2020-01-22,1,0,0,1,0,0
甘肃,2020-01-24,1,0,0,2,0,0
甘肃,2020-01-25,2,0,0,4,0,0
甘肃,2020-01-26,4,0,0,8,0,0
甘肃,2020-01-27,3,0,0,11,0,0
甘肃,2020-01-28,2,0,0,13,0,0
甘肃,2020-01-30,2,0,0,15,0,0
甘肃,2020-01-31,5,0,0,20,0,0
甘肃,2020-02-01,3,0,0,23,0,0
甘肃,2020-02-02,3,2,0,26,2,0
甘肃,2020-02-03,2,0,0,28,2,0
甘肃,2020-02-04,2,1,0,30,3,0
甘肃,2020-02-06,2,2,0,32,5,0
甘肃,2020-02-07,0,0,1,32,5,1
甘肃,2020-02-08,1,3,0,33,8,1
甘肃,2020-02-09,0,2,1,33,10,2
甘肃,2020-02-10,2,4,0,35,14,2
甘肃,2020-02-12,0,1,0,35,15,2
甘肃,2020-02-13,0,2,0,35,17,2
甘肃,2020-02-16,0,3,0,35,20,2
甘肃,2020-02-17,1,0,0,36,20,2
甘肃,2020-02-18,0,3,0,36,23,2
甘肃,2020-02-19,0,1,0,36,24,2
甘肃,2020-02-20,0,3,0,36,27,2
甘肃,2020-02-21,0,2,0,36,29,2
甘肃,2020-02-23,0,2,0,36,31,2
甘肃,2020-02-26,0,1,0,36,32,2
甘肃,2020-03-02,0,1,0,36,33,2
甘肃,2020-03-09,0,1,0,36,34,2
甘肃,2020-03-29,1,0,0,37,34,2
甘肃,2020-04-05,0,1,0,37,35,2
海南,2020-01-22,1,0,0,1,0,0
海南,2020-01-31,2,0,0,3,0,0
海南,2020-02-01,1,0,0,4,0,0
海南,2020-02-04,1,0,0,5,0,0
海南,2020-02-09,1,1,0,6,1,0
海南,2020-02-12,0,1,0,6,2,0
海南,2020-02-14,0,1,0,6,3,0
海南,2020-02-17,0,1,0,6,4,0
海南,2020-02-23,0,1,0,6,5,0
海南,2020-02-25,0,1,0,6,6,0
山东,2020-01-22,2,0,0,2,0,0
山东,2020-01-24,1,0,0,3,0,0
山东,2020-01-25,4,0,0,7,0,0
山东,2020-01-27,1,0,0,8,0,0
山东,2020-01-28,7,0,0,15,0,0
山东,2020-01-29,1,0,0,16,0,0
山东,2020-01-30,4,0,0,20,0,0
山东,2020-01-31,3,0,0,23,0,0
山东,2020-02-01,1,0,0,24,0,0
山东,2020-02-03,3,1,0,27,1,0
山东,2020-02-04,3,0,0,30,1,0
山东,2020-02-05,2,0,0,32,1,0
山东,2020-02-06,3,2,0,35,3,0
山东,2020-02-07,3,0,0,38,3,0
山东,2020-02-08,2,1,0,40,4,0
山东,2020-02-09,2,2,0,42,6,0
山东,2020-02-10,2,3,0,44,9,0
山东,2020-02-11,1,1,0,45,10,0
山东,2020-02-12,0,2,0,45,12,0
山东,2020-02-13,2,1,0,47,13,0
山东,2020-02-14,0,12,0,47,25,0
山东,2020-02-15,0,4,0,47,29,0
山东,2020-02-16,0,3,0,47,32,0
山东,2020-02-17,1,3,0,48,35,0
山东,2020-02-18,0,2,0,48,37,0
山东,2020-02-19,1,4,0,49,41,0
山东,2020-02-20,0,2,0,49,43,0
山东,2020-02-21,0,1,0,49,44,0
山东,2020-02-25,0,1,0,49,45,0
山东,2020-02-29,0,1,0,49,46,0
山东,2020-03-01,0,1,0,49,47,0
山东,2020-03-04,0,1,0,49,48,0
山东,2020-03-14,0,1,0,49,49,0
广西,2020-01-22,1,0,0,1,0,0
广西,2020-01-23,1,0,0,2,0,0
广西,2020-01-24,1,0,0,3,0,0
广西,2020-01-25,1,0,0,4,0,0
广西,2020-01-26,2,0,0,6,0,0
广西,2020-01-29,4,0,0,10,0,0
广西,2020-01-30,1,0,0,11,0,0
广西,2020-01-31,1,0,0,12,0,0
广西,2020-02-02,2,0,0,14,0,0
广西,2020-02-03,1,0,0,15,0,0
广西,2020-02-04,2,1,0,17,1,0
广西,2020-02-05,3,2,0,20,3,0
广西,2020-02-09,2,0,0,22,3,0
广西,2020-02-10,0,3,0,22,6,0
广西,2020-02-12,0,1,0,22,7,0
广西,2020-02-14,2,0,0,24,7,0
广西,2020-02-15,0,1,0,24,8,0
广西,2020-02-19,0,2,0,24,10,0
广西,2020-02-20,0,1,0,24,11,0
广西,2020-02-23,0,1,0,24,12,0
广西,2020-02-26,0,3,0,24,15,0
广西,2020-02-29,0,1,0,24,16,0
广西,2020-03-02,0,1,0,24,17,0
广西,2020-03-03,0,2,0,24,19,0
广西,2020-03-05,0,1,0,24,20,0
广西,2020-03-07,0,1,0,24,21,0
广西,2020-03-10,0,1,0,24,22,0
广西,2020-03-11,0,1,0,24,23,0
广西,2020-03-15,0,1,0,24,24,0
安徽,2020-01-22,1,0,0,1,0,0
安徽,2020-01-23,1,0,0,2,0,0
安徽,2020-01-25,1,0,0,3,0,0
安徽,2020-01-27,1,0,0,4,0,0
安徽,2020-01-28,2,0,0,6,0,0
安徽,2020-01-29,2,0,0,8,0,0
安徽,2020-01-30,1,1,0,9,1,0
安徽,2020-01-31,4,0,0,13,1,0
安徽,2020-02-02,7,0,0,20,1,0
安徽,2020-02-03,10,0,0,30,1,0
安徽,2020-02-04,4,0,0,34,1,0
安徽,2020-02-05,2,0,0,36,1,0
安徽,2020-02-06,5,0,0,41,1,0
安徽,2020-02-07,10,0,0,51,1,0
安徽,2020-02-08,3,1,0,54,2,0
安徽,2020-02-09,3,0,0,57,2,0
安徽,2020-02-10,2,1,0,59,3,0
安徽,2020-02-12,1,0,0,60,3,0
安徽,2020-02-13,1,0,0,61,3,0
安徽,2020-02-14,2,5,0,63,8,0
安徽,2020-02-15,2,7,0,65,15,0
安徽,2020-02-16,3,1,0,68,16,0
安徽,2020-02-17,0,5,0,68,21,0
安徽,2020-02-18,1,2,0,69,23,0
安徽,2020-02-19,0,7,0,69,30,0
安徽,2020-02-20,0,5,0,69,35,0
安徽,2020-02-21,0,4,0,69,39,0
安徽,2020-02-22,0,4,0,69,43,0
安徽,2020-02-23,0,1,0,69,44,0
安徽,2020-02-24,0,1,0,69,45,0
安徽,2020-02-25,0,1,0,69,46,0
安徽,2020-02-26,0,2,0,69,48,0
安徽,2020-02-27,0,5,0,69,53,0
安徽,2020-02-28,0,2,0,69,55,0
安徽,2020-02-29,0,2,0,69,57,0
安徽,2020-03-01,0,1,0,69,58,0
安徽,2020-03-02,0,5,0,69,63,0
安徽,2020-03-03,0,6,0,69,69,0
河南,2020-01-22,1,0,0,1,0,0
河南,2020-01-26,1,0,0,2,0,0
河南,2020-01-30,1,0,0,3,0,0
河南,2020-01-31,2,0,0,5,0,0
河南,2020-02-01,2,0,0,7,0,0
河南,2020-02-03,5,1,0,12,1,0
河南,2020-02-04,5,0,0,17,1,0
河南,2020-02-05,4,0,0,21,1,0
河南,2020-02-06,3,0,0,24,1,0
河南,2020-02-07,1,1,0,25,2,0
河南,2020-02-09,2,0,0,27,2,0
河南,2020-02-10,1,0,0,28,2,0
河南,2020-02-11,1,0,0,29,2,0
河南,2020-02-12,1,2,0,30,4,0
河南,2020-02-14,1,4,0,31,8,0
河南,2020-02-15,0,2,0,31,10,0
河南,2020-02-16,0,1,0,31,11,0
河南,2020-02-17,0,0,1,31,11,1
河南,2020-02-18,0,1,0,31,12,1
河南,2020-02-19,0,1,0,31,13,1
河南,2020-02-20,0,2,0,31,15,1
河南,2020-02-21,0,1,0,31,16,1
河南,2020-02-22,0,2,0,31,18,1
河南,2020-02-24,0,2,0,31,20,1
河南,2020-02-25,0,1,0,31,21,1
河南,2020-02-26,0,3,0,31,24,1
河南,2020-02-27,0,2,0,31,26,1
河南,2020-02-28,0,1,0,31,27,1
河南,2020-03-01,0,3,0,31,30,1
四川,2020-01-22,2,0,0,2,0,0
四川,2020-01-25,3,0,0,5,0,0
四川,2020-01-26,2,0,0,7,0,0
四川,2020-01-27,1,0,0,8,0,0
四川,2020-01-29,1,0,0,9,0,0
四川,2020-01-30,2,0,0,11,0,0
四川,2020-01-31,1,0,0,12,0,0
四川,2020-02-01,2,0,0,14,0,0
四川,2020-02-02,3,1,0,17,1,0
四川,2020-02-04,0,1,0,17,2,0
四川,2020-02-05,1,0,0,18,2,0
四川,2020-02-06,1,0,0,19,2,0
四川,2020-02-07,1,0,0,20,2,0
四川,2020-02-08,0,1,0,20,3,0
四川,2020-02-09,1,1,0,21,4,0
四川,2020-02-11,1,0,0,22,4,0
四川,2020-02-13,0,1,0,22,5,0
四川,2020-02-15,0,1,0,22,6,0
四川,2020-02-17,0,3,0,22,9,0
四川,2020-02-18,0,1,0,22,10,0
四川,2020-02-21,0,2,0,22,12,0
四川,2020-02-25,0,2,0,22,14,0
四川,2020-02-28,0,1,0,22,15,0
四川,2020-03-01,0,1,0,22,16,0
四川,2020-03-04,0,2,0,22,18,0
四川,2020-03-10,0,2,0,22,20,0
四川,2020-03-13,0,2,0,22,22,0
黑龙江,2020-01-22,1,0,0,1,0,0
黑龙江,2020-01-30,1,0,0,2,0,0
黑龙江,2020-01-31,4,0,0,6,0,0
黑龙江,2020-02-01,1,0,0,7,0,0
黑龙江,2020-02-02,1,0,0,8,0,0
黑龙江,2020-02-04,1,0,0,9,0,0
黑龙江,2020-02-05,1,0,0,10,0,0
黑龙江,2020-02-06,1,0,0,11,0,0
黑龙江,2020-02-07,1,0,0,12,0,0
黑龙江,2020-02-16,0,1,0,12,1,0
黑龙江,2020-02-17,1,0,0,13,1,0
黑龙江,2020-02-19,1,0,0,14,1,0
黑龙江,2020-02-21,0,1,0,14,2,0
黑龙江,2020-02-22,0,4,0,14,6,0
黑龙江,2020-02-23,0,1,0,14,7,0
黑龙江,2020-02-24,0,1,0,14,8,0
黑龙江,2020-02-26,0,1,0,14,9,0
黑龙江,2020-03-03,0,2,0,14,11,0
黑龙江,2020-03-04,1,0,0,15,11,0
黑龙江,2020-03-07,0,2,0,15,13,0
黑龙江,2020-03-13,0,1,0,15,14,0
黑龙江,2020-03-14,0,1,0,15,15,0
黑龙江,2020-04-18,2,0,0,17,15,0
黑龙江,2020-04-25,3,0,0,20,15,0
黑龙江,2020-04-30,5,0,0,25,15,0
黑龙江,2020-05-04,0,1,0,25,16,0
黑龙江,2020-05-06,0,2,0,25,18,0
黑龙江,2020-05-07,0,2,0,25,20,0
黑龙江,2020-05-09,0,2,0,25,22,0
黑龙江,2020-05-11,0,3,0,25,25,0
江西,2020-01-22,1,0,0,1,0,0
江西,2020-01-23,1,0,0,2,0,0
江西,2020-01-24,1,0,0,3,0,0
江西,2020-01-25,1,0,0,4,0,0
江西,2020-01-26,4,0,0,8,0,0
江西,2020-01-27,9,0,0,17,0,0
江西,2020-01-28,8,0,0,25,0,0
江西,2020-01-29,21,0,0,46,0,0
江西,2020-01-30,21,1,0,67,1,0
江西,2020-01-31,16,0,0,83,1,0
江西,2020-02-01,6,0,0,89,1,0
江西,2020-02-02,14,3,0,103,4,0
江西,2020-02-03,18,0,0,121,4,0
江西,2020-02-04,13,3,0,134,7,0
江西,2020-02-05,15,3,0,149,10,0
江西,2020-02-06,13,4,0,162,14,0
江西,2020-02-07,6,6,0,168,20,0
江西,2020-02-08,11,7,0,179,27,0
江西,2020-02-09,11,8,0,190,35,0
江西,2020-02-10,6,11,0,196,46,0
江西,2020-02-11,10,7,0,206,53,0
江西,2020-02-12,5,8,0,211,61,0
江西,2020-02-13,7,7,0,218,68,0
江西,2020-02-14,5,5,0,223,73,0
江西,2020-02-15,5,3,0,228,76,0
江西,2020-02-16,1,14,0,229,90,0
江西,2020-02-17,0,5,0,229,95,0
江西,2020-02-18,0,19,0,229,114,0
江西,2020-02-19,0,19,0,229,133,0
江西,2020-02-20,0,12,0,229,145,0
江西,2020-02-21,0,17,0,229,162,0
江西,2020-02-22,0,16,0,229,178,0
江西,2020-02-23,0,3,0,229,181,0
江西,2020-02-24,0,3,0,229,184,0
江西,2020-02-25,0,3,0,229,187,0
江西,2020-02-26,0,6,0,229,193,0
江西,2020-02-27,1,5,0,230,198,0
江西,2020-02-28,0,4,0,230,202,0
江西,2020-02-29,0,5,0,230,207,0
江西,2020-03-01,0,5,0,230,212,0
江西,2020-03-02,0,4,0,230,216,0
江西,2020-03-03,0,2,0,230,218,0
江西,2020-03-04,0,1,0,230,219,0
江西,2020-03-05,0,3,0,230,222,0
江西,2020-03-06,0,1,0,230,223,0
江西,2020-03-07,0,1,0,230,224,0
江西,2020-03-08,0,1,0,230,225,0
江西,2020-03-09,0,2,0,230,227,0
江西,2020-03-10,0,2,0,230,229,0
江西,2020-03-11,0,1,0,230,230,0
天津,2020-01-22,1,0,0,1,0,0
天津,2020-02-02,1,0,0,2,0,0
天津,2020-02-03,1,0,0,3,0,0
天津,2020-02-11,1,0,0,4,0,0
天津,2020-02-13,2,0,0,6,0,0
天津,2020-02-14,0,1,0,6,1,0
天津,2020-02-16,1,0,0,7,1,0
天津,2020-02-20,0,1,0,7,2,0
天津,2020-02-27,0,2,0,7,4,0
天津,2020-03-02,0,1,0,7,5,0
天津,2020-03-03,0,1,0,7,6,0
贵州,2020-01-22,1,0,0,1,0,0
贵州,2020-01-26,1,0,0,2,0,0
贵州,2020-01-27,2,0,0,4,0,0
贵州,2020-02-01,1,0,0,5,0,0
贵州,2020-02-03,1,0,0,6,0,0
贵州,2020-02-04,0,3,0,6,3,0
贵州,2020-02-06,1,0,0,7,3,0
贵州,2020-02-09,1,0,0,8,3,0
贵州,2020-02-11,9,0,0,17,3,0
贵州,2020-02-13,0,2,0,17,5,0
贵州,2020-02-16,0,1,0,17,6,0
贵州,2020-02-17,0,1,0,17,7,0
贵州,2020-02-21,0,5,0,17,12,0
贵州,2020-02-23,0,1,0,17,13,0
贵州,2020-02-26,0,2,0,17,15,0
贵州,2020-03-08,0,1,0,17,16,0
贵州,2020-03-11,0,1,0,17,17,0
浙江,2020-01-22,1,0,0,1,0,0
浙江,2020-01-23,1,0,0,2,0,0
浙江,2020-01-25,1,0,0,3,0,0
浙江,2020-01-26,2,0,0,5,0,0
浙江,2020-01-28,3,0,0,8,0,0
浙江,2020-01-29,2,0,0,10,0,0
浙江,2020-01-30,2,0,0,12,0,0
浙江,2020-01-31,1,0,0,13,0,0
浙江,2020-02-02,1,0,0,14,0,0
浙江,2020-02-05,0,2,0,14,2,0
浙江,2020-02-07,0,1,0,14,3,0
浙江,2020-02-10,0,2,0,14,5,0
浙江,2020-02-13,0,3,0,14,8,0
浙江,2020-02-15,0,1,0,14,9,0
浙江,2020-02-17,0,1,0,14,10,0
浙江,2020-02-25,0,1,0,14,11,0
浙江,2020-02-28,0,1,0,14,12,0
浙江,2020-03-05,0,2,0,14,14,0
河南,2020-01-22,1,0,0,1,0,0
河南,2020-01-25,1,0,0,2,0,0
河南,2020-01-26,1,0,0,3,0,0
河南,2020-01-28,1,0,0,4,0,0
河南,2020-01-29,1,0,0,5,0,0
河南,2020-01-30,1,0,0,6,0,0
河南,2020-01-31,1,0,0,7,0,0
河南,2020-02-01,0,1,0,7,1,0
河南,2020-02-19,0,1,0,7,2,0
河南,2020-02-20,0,5,0,7,7,0
海南,2020-01-22,1,0,0,1,0,0
海南,2020-01-23,1,0,0,2,0,0
海南,2020-01-24,3,0,0,5,0,0
海南,2020-01-25,3,0,0,8,0,0
海南,2020-01-26,2,0,0,10,0,0
海南,2020-01-27,4,0,0,14,0,0
海南,2020-01-29,0,1,0,14,1,0
海南,2020-01-31,1,0,0,15,1,0
海南,2020-02-01,2,0,0,17,1,0
海南,2020-02-02,0,3,0,17,4,0
海南,2020-02-03,1,0,0,18,4,0
海南,2020-02-04,4,0,0,22,4,0
海南,2020-02-05,8,1,0,30,5,0
海南,2020-02-06,2,1,1,32,6,1
海南,2020-02-07,5,3,0,37,9,1
海南,2020-02-08,3,1,0,40,10,1
海南,2020-02-09,1,1,0,41,11,1
海南,2020-02-10,4,0,0,45,11,1
海南,2020-02-11,1,0,0,46,11,1
海南,2020-02-12,8,0,0,54,11,1
海南,2020-02-13,0,3,0,54,14,1
海南,2020-02-14,0,1,0,54,15,1
海南,2020-02-18,0,7,0,54,22,1
海南,2020-02-20,0,3,0,54,25,1
海南,2020-02-21,0,5,0,54,30,1
海南,2020-02-22,0,3,0,54,33,1
海南,2020-02-24,0,6,0,54,39,1
海南,2020-02-25,0,1,0,54,40,1
海南,2020-02-26,0,4,0,54,44,1
海南,2020-02-29,0,7,0,54,51,1
海南,2020-03-03,0,1,0,54,52,1
海南,2020-03-04,0,1,0,54,53,1
浙江,2020-01-22,1,0,0,1,0,0
浙江,2020-01-24,3,0,0,4,0,0
浙江,2020-01-25,1,0,0,5,0,0
浙江,2020-01-26,1,0,0,6,0,0
浙江,2020-01-27,1,0,0,7,0,0
浙江,2020-01-28,12,0,0,19,0,0
浙江,2020-01-30,4,0,0,23,0,0
浙江,2020-01-31,1,0,0,24,0,0
浙江,2020-02-01,3,1,0,27,1,0
浙江,2020-02-02,3,1,0,30,2,0
浙江,2020-02-03,0,1,0,30,3,0
浙江,2020-02-05,3,0,0,33,3,0
浙江,2020-02-06,1,0,0,34,3,0
浙江,2020-02-07,2,2,0,36,5,0
浙江,2020-02-08,2,3,0,38,8,0
浙江,2020-02-09,3,0,0,41,8,0
浙江,2020-02-10,0,4,0,41,12,0
浙江,2020-02-11,0,1,0,41,13,0
浙江,2020-02-12,0,2,0,41,15,0
浙江,2020-02-13,1,1,0,42,16,0
浙江,2020-02-14,0,1,0,42,17,0
浙江,2020-02-16,0,1,0,42,18,0
浙江,2020-02-17,0,1,0,42,19,0
浙江,2020-02-18,0,1,0,42,20,0
浙江,2020-02-21,0,1,0,42,21,0
浙江,2020-02-22,0,6,0,42,27,0
浙江,2020-02-23,0,3,0,42,30,0
浙江,2020-02-26,0,1,0,42,31,0
浙江,2020-02-27,0,5,0,42,36,0
浙江,2020-03-01,0,1,0,42,37,0
浙江,2020-03-02,0,1,0,42,38,0
浙江,2020-03-05,0,1,0,42,39,0
浙江,2020-03-10,0,2,0,42,41,0
浙江,2020-03-16,0,1,0,42,42,0
辽宁,2020-01-22,1,0,0,1,0,0
辽宁,2020-01-23,1,0,0,2,0,0
辽宁,2020-01-24,1,0,0,3,0,0
辽宁,2020-01-25,2,0,0,5,0,0
辽宁,2020-01-26,1,0,0,6,0,0
辽宁,2020-01-27,2,0,0,8,0,0
辽宁,2020-01-29,1,0,0,9,0,0
辽宁,2020-01-30,1,0,0,10,0,0
辽宁,2020-01-31,3,0,0,13,0,0
辽宁,2020-02-03,2,0,0,15,0,0
辽宁,2020-02-04,3,0,0,18,0,0
辽宁,2020-02-05,5,1,0,23,1,0
辽宁,2020-02-06,1,0,0,24,1,0
辽宁,2020-02-07,1,1,0,25,2,0
辽宁,2020-02-08,1,1,0,26,3,0
辽宁,2020-02-09,0,2,0,26,5,0
辽宁,2020-02-11,2,2,0,28,7,0
辽宁,2020-02-14,0,2,0,28,9,0
辽宁,2020-02-16,0,2,0,28,11,0
辽宁,2020-02-21,0,4,0,28,15,0
辽宁,2020-02-22,0,1,0,28,16,0
辽宁,2020-02-23,0,2,0,28,18,0
辽宁,2020-02-24,0,2,0,28,20,0
辽宁,2020-02-25,0,2,0,28,22,0
辽宁,2020-02-26,0,1,0,28,23,0
辽宁,2020-02-28,0,1,0,28,24,0
辽宁,2020-02-29,0,1,0,28,25,0
辽宁,2020-03-09,0,1,0,28,26,0
辽宁,2020-03-17,0,1,0,28,27,0
辽宁,2020-03-22,0,1,0,28,28,0
辽宁,2020-05-10,1,0,0,29,28,0
辽宁,2020-05-13,2,0,0,31,28,0
辽宁,2020-05-24,0,1,0,31,29,0
辽宁,2020-05-25,0,2,0,31,31,0
辽宁,2020-06-13,2,0,0,33,31,0
辽宁,2020-06-18,1,0,0,34,31,0
河北,2020-01-22,1,0,0,1,0,0
河北,2020-01-24,3,0,0,4,0,0
河北,2020-01-25,1,0,0,5,0,0
河北,2020-01-26,2,0,0,7,0,0
河北,2020-01-27,2,0,0,9,0,0
河北,2020-01-28,1,0,0,10,0,0
河北,2020-01-29,1,0,0,11,0,0
河北,2020-01-31,1,0,0,12,0,0
河北,2020-02-01,1,0,0,13,0,0
河北,2020-02-02,3,0,0,16,0,0
河北,2020-02-03,5,0,0,21,0,0
河北,2020-02-04,0,1,0,21,1,0
河北,2020-02-05,3,1,0,24,2,0
河北,2020-02-06,0,1,0,24,3,0
河北,2020-02-09,1,0,0,25,3,0
河北,2020-02-10,2,0,0,27,3,0
河北,2020-02-13,0,1,0,27,4,0
河北,2020-02-14,0,3,0,27,7,0
河北,2020-02-15,1,0,0,28,7,0
河北,2020-02-17,0,4,0,28,11,0
河北,2020-02-19,0,2,0,28,13,0
河北,2020-02-20,0,1,0,28,14,0
河北,2020-02-21,1,1,0,29,15,0
河北,2020-02-22,0,4,0,29,19,0
河北,2020-02-23,0,2,0,29,21,0
河北,2020-02-24,0,1,0,29,22,0
河北,2020-02-27,0,2,0,29,24,0
河北,2020-02-29,0,3,0,29,27,0
河北,2020-03-02,0,1,0,29,28,0
河北,2020-03-06,0,1,0,29,29,0
北京,2020-01-22,1,0,0,1,0,0
北京,2020-01-26,1,0,0,2,0,0
北京,2020-01-31,1,0,0,3,0,0
北京,2020-02-01,1,0,0,4,0,0
北京,2020-02-02,1,0,0,5,0,0
北京,2020-02-03,1,0,0,6,0,0
北京,2020-02-04,1,0,0,7,0,0
北京,2020-02-05,4,0,0,11,0,0
北京,2020-02-06,2,0,0,13,0,0
北京,2020-02-13,1,0,0,14,0,0
北京,2020-06-14,1,0,0,15,0,0
江苏,2020-01-22,1,0,0,1,0,0
江苏,2020-01-23,1,0,0,2,0,0
江苏,2020-01-24,1,1,0,3,1,0
江苏,2020-01-25,4,0,0,7,1,0
江苏,2020-01-26,1,0,0,8,1,0
江苏,2020-01-27,4,0,0,12,1,0
江苏,2020-01-28,8,0,0,20,1,0
江苏,2020-01-29,4,0,0,24,1,0
江苏,2020-01-30,8,1,0,32,2,0
江苏,2020-01-31,2,0,0,34,2,0
江苏,2020-02-01,4,0,0,38,2,0
江苏,2020-02-02,6,1,0,44,3,0
江苏,2020-02-03,8,0,0,52,3,0
江苏,2020-02-04,3,0,0,55,3,0
江苏,2020-02-05,5,1,0,60,4,0
江苏,2020-02-06,9,0,0,69,4,0
江苏,2020-02-07,3,0,0,72,4,0
江苏,2020-02-08,3,0,0,75,4,0
江苏,2020-02-09,2,7,0,77,11,0
江苏,2020-02-10,3,2,0,80,13,0
江苏,2020-02-11,4,0,0,84,13,0
江苏,2020-02-12,1,3,0,85,16,0
江苏,2020-02-13,0,1,0,85,17,0
江苏,2020-02-14,1,0,0,86,17,0
江苏,2020-02-15,0,9,0,86,26,0
江苏,2020-02-17,1,5,0,87,31,0
江苏,2020-02-19,0,2,0,87,33,0
江苏,2020-02-20,0,5,0,87,38,0
江苏,2020-02-21,0,4,0,87,42,0
江苏,2020-02-22,0,7,0,87,49,0
江苏,2020-02-23,0,1,0,87,50,0
江苏,2020-02-24,0,7,0,87,57,0
江苏,2020-02-26,0,2,0,87,59,0
江苏,2020-02-28,0,3,0,87,62,0
江苏,2020-02-29,0,2,0,87,64,0
江苏,2020-03-02,0,3,0,87,67,0
江苏,2020-03-03,0,2,0,87,69,0
江苏,2020-03-04,0,1,0,87,70,0
江苏,2020-03-05,0,5,0,87,75,0
江苏,2020-03-06,0,3,0,87,78,0
江苏,2020-03-07,0,2,0,87,80,0
江苏,2020-03-08,0,4,0,87,84,0
江苏,2020-03-10,0,3,0,87,87,0
山西,2020-01-22,1,0,0,1,0,0
山西,2020-01-24,1,0,0,2,0,0
山西,2020-01-27,1,0,0,3,0,0
山西,2020-01-29,0,1,0,3,1,0
山西,2020-01-30,1,0,0,4,1,0
山西,2020-02-01,2,0,0,6,1,0
山西,2020-02-04,3,0,0,9,1,0
山西,2020-02-06,2,0,0,11,1,0
山西,2020-02-07,1,0,0,12,1,0
山西,2020-02-08,3,0,0,15,1,0
山西,2020-02-09,2,2,0,17,3,0
山西,2020-02-10,1,0,0,18,3,0
山西,2020-02-14,1,0,0,19,3,0
山西,2020-02-15,0,3,0,19,6,0
山西,2020-02-18,0,2,0,19,8,0
山西,2020-02-19,0,2,0,19,10,0
山西,2020-02-20,1,2,0,20,12,0
山西,2020-02-24,0,2,0,20,14,0
山西,2020-02-26,0,2,0,20,16,0
山西,2020-02-27,0,2,0,20,18,0
山西,2020-02-28,0,1,0,20,19,0
山西,2020-03-01,0,1,0,20,20,0
山西,2020-05-02,1,0,0,21,20,0
山西,2020-05-09,0,1,0,21,21,0
贵州,2020-01-22,1,0,0,1,0,0
贵州,2020-01-24,1,0,0,2,0,0
贵州,2020-01-31,1,1,0,3,1,0
贵州,2020-02-02,3,0,0,6,1,0
贵州,2020-02-05,0,1,0,6,2,0
贵州,2020-02-08,1,0,0,7,2,0
贵州,2020-02-09,1,0,0,8,2,0
贵州,2020-02-10,1,3,0,9,5,0
贵州,2020-02-11,1,0,0,10,5,0
贵州,2020-02-13,0,1,0,10,6,0
贵州,2020-02-15,0,1,0,10,7,0
贵州,2020-02-17,0,2,0,10,9,0
贵州,2020-02-21,0,1,0,10,10,0
海南,2020-01-22,1,0,0,1,0,0
海南,2020-01-23,1,0,0,2,0,0
海南,2020-01-24,3,0,0,5,0,0
海南,2020-01-26,2,0,0,7,0,0
海南,2020-01-28,1,0,0,8,0,0
海南,2020-02-03,3,0,0,11,0,0
海南,2020-02-07,1,0,0,12,0,0
海南,2020-02-10,1,0,0,13,0,0
海南,2020-02-12,0,1,0,13,1,0
海南,2020-02-14,0,2,0,13,3,0
海南,2020-02-16,0,1,0,13,4,0
海南,2020-02-18,0,5,0,13,9,0
海南,2020-02-24,0,2,0,13,11,0
海南,2020-02-27,0,1,0,13,12,0
海南,2020-03-04,0,1,0,13,13,0
广西,2020-01-22,1,0,0,1,0,0
广西,2020-01-25,1,0,0,2,0,0
广西,2020-01-27,2,0,0,4,0,0
广西,2020-01-28,0,1,0,4,1,0
广西,2020-01-31,1,0,0,5,1,0
广西,2020-02-03,0,1,0,5,2,0
广西,2020-02-08,0,1,0,5,3,0
广西,2020-02-10,0,2,0,5,5,0
陕西,2020-01-22,2,0,0,2,0,0
陕西,2020-01-24,2,0,0,4,0,0
陕西,2020-01-25,4,0,0,8,0,0
陕西,2020-01-26,4,0,0,12,0,0
陕西,2020-01-27,3,0,0,15,0,0
陕西,2020-01-28,3,0,0,18,0,0
陕西,2020-01-29,4,0,0,22,0,0
陕西,2020-01-30,9,0,0,31,0,0
陕西,2020-01-31,8,0,0,39,0,0
陕西,2020-02-01,8,0,0,47,0,0
陕西,2020-02-02,8,0,0,55,0,0
陕西,2020-02-03,5,1,0,60,1,0
陕西,2020-02-04,10,1,0,70,2,0
陕西,2020-02-05,4,3,0,74,5,0
陕西,2020-02-06,6,0,0,80,5,0
陕西,2020-02-07,8,4,0,88,9,0
陕西,2020-02-08,8,1,0,96,10,0
陕西,2020-02-09,2,2,0,98,12,0
陕西,2020-02-10,6,0,0,104,12,0
陕西,2020-02-11,6,3,0,110,15,0
陕西,2020-02-12,4,0,0,114,15,0
陕西,2020-02-13,0,5,0,114,20,0
陕西,2020-02-14,0,3,0,114,23,0
陕西,2020-02-15,0,7,0,114,30,0
陕西,2020-02-16,3,5,0,117,35,0
陕西,2020-02-17,0,2,0,117,37,0
陕西,2020-02-18,1,3,0,118,40,0
陕西,2020-02-19,2,6,1,120,46,1
陕西,2020-02-20,0,4,0,120,50,1
陕西,2020-02-21,0,15,0,120,65,1
陕西,2020-02-22,0,6,0,120,71,1
陕西,2020-02-23,0,3,0,120,74,1
陕西,2020-02-24,0,6,0,120,80,1
陕西,2020-02-25,0,7,0,120,87,1
陕西,2020-02-26,0,5,0,120,92,1
陕西,2020-02-27,0,3,0,120,95,1
陕西,2020-02-28,0,3,0,120,98,1
陕西,2020-02-29,0,2,0,120,100,1
陕西,2020-03-01,0,1,0,120,101,1
陕西,2020-03-02,0,3,0,120,104,1
陕西,2020-03-05,0,4,0,120,108,1
陕西,2020-03-11,0,2,1,120,110,2
陕西,2020-03-16,0,0,1,120,110,3
陕西,2020-03-17,0,3,0,120,113,3
陕西,2020-03-18,0,1,0,120,114,3
陕西,2020-03-25,0,3,0,120,117,3
陕西,2020-01-22,1,0,0,1,0,0
陕西,2020-01-24,2,0,0,3,0,0
陕西,2020-01-26,1,0,0,4,0,0
陕西,2020-01-28,1,0,0,5,0,0
陕西,2020-01-30,1,0,0,6,0,0
陕西,2020-01-31,2,0,0,8,0,0
陕西,2020-02-01,1,0,0,9,0,0
陕西,2020-02-03,3,0,0,12,0,0
陕西,2020-02-04,4,0,0,16,0,0
陕西,2020-02-06,0,1,0,16,1,0
陕西,2020-02-07,1,0,0,17,1,0
陕西,2020-02-08,0,1,0,17,2,0
陕西,2020-02-09,1,0,0,18,2,0
陕西,2020-02-10,0,2,0,18,4,0
陕西,2020-02-14,0,1,0,18,5,0
陕西,2020-02-16,0,1,0,18,6,0
陕西,2020-02-18,0,1,0,18,7,0
陕西,2020-02-19,0,1,0,18,8,0
陕西,2020-02-21,0,4,0,18,12,0
陕西,2020-02-22,0,2,0,18,14,0
陕西,2020-02-24,0,1,0,18,15,0
陕西,2020-02-29,0,2,0,18,17,0
陕西,2020-03-25,0,1,0,18,18,0
香港,2020-01-22,1,0,0,1,0,0
香港,2020-01-23,1,0,0,2,0,0
香港,2020-01-24,3,0,0,5,0,0
香港,2020-01-26,3,0,0,8,0,0
香港,2020-01-28,2,0,0,10,0,0
香港,2020-01-29,2,0,0,12,0,0
香港,2020-01-31,1,0,0,13,0,0
香港,2020-02-01,1,0,0,14,0,0
香港,2020-02-02,1,0,0,15,0,0
香港,2020-02-04,3,0,1,18,0,1
香港,2020-02-05,3,0,0,21,0,1
香港,2020-02-06,3,0,0,24,0,1
香港,2020-02-07,2,0,0,26,0,1
香港,2020-02-09,10,0,0,36,0,1
香港,2020-02-10,6,0,0,42,0,1
香港,2020-02-11,7,0,0,49,0,1
香港,2020-02-12,1,1,0,50,1,1
香港,2020-02-13,3,0,0,53,1,1
香港,2020-02-14,3,0,0,56,1,1
香港,2020-02-16,1,1,0,57,2,1
香港,2020-02-17,3,0,0,60,2,1
香港,2020-02-18,2,2,0,62,4,1
香港,2020-02-19,3,1,1,65,5,2
香港,2020-02-20,3,0,0,68,5,2
香港,2020-02-21,0,1,0,68,6,2
香港,2020-02-22,1,5,0,69,11,2
香港,2020-02-23,5,1,0,74,12,2
香港,2020-02-24,7,6,0,81,18,2
香港,2020-02-25,4,0,0,85,18,2
香港,2020-02-26,6,6,0,91,24,2
香港,2020-02-27,2,2,0,93,26,2
香港,2020-02-28,1,4,0,94,30,2
香港,2020-02-29,1,3,0,95,33,2
香港,2020-03-01,3,3,0,98,36,2
香港,2020-03-02,2,0,0,100,36,2
香港,2020-03-03,0,1,0,100,37,2
香港,2020-03-04,4,6,0,104,43,2
香港,2020-03-05,0,3,0,104,46,2
香港,2020-03-06,3,5,0,107,51,2
香港,2020-03-07,2,4,0,109,55,2
香港,2020-03-08,5,4,1,114,59,3
香港,2020-03-09,1,1,0,115,60,3
香港,2020-03-10,5,5,0,120,65,3
香港,2020-03-11,9,2,0,129,67,3
香港,2020-03-12,2,8,0,131,75,3
香港,2020-03-13,6,3,1,137,78,4
香港,2020-03-14,4,3,0,141,81,4
香港,2020-03-15,7,3,0,148,84,4
香港,2020-03-16,9,4,0,157,88,4
香港,2020-03-17,10,4,0,167,92,4
香港,2020-03-18,25,3,0,192,95,4
香港,2020-03-19,16,3,0,208,98,4
香港,2020-03-20,48,0,0,256,98,4
香港,2020-03-21,17,2,0,273,100,4
香港,2020-03-22,44,0,0,317,100,4
香港,2020-03-23,39,1,0,356,101,4
香港,2020-03-24,30,1,0,386,102,4
香港,2020-03-25,24,4,0,410,106,4
香港,2020-03-26,43,4,0,453,110,4
香港,2020-03-27,65,1,0,518,111,4
香港,2020-03-28,64,1,0,582,112,4
香港,2020-03-29,59,6,0,641,118,4
香港,2020-03-30,41,6,0,682,124,4
香港,2020-03-31,32,4,0,714,128,4
香港,2020-04-01,51,19,0,765,147,4
香港,2020-04-02,37,7,0,802,154,4
香港,2020-04-03,43,19,0,845,173,4
香港,2020-04-04,17,13,0,862,186,4
香港,2020-04-05,28,20,0,890,206,4
香港,2020-04-06,24,10,0,914,216,4
香港,2020-04-07,21,20,0,935,236,4
香港,2020-04-08,25,28,0,960,264,4
香港,2020-04-09,13,29,0,973,293,4
香港,2020-04-10,16,16,0,989,309,4
香港,2020-04-11,11,27,0,1000,336,4
香港,2020-04-12,4,24,0,1004,360,4
香港,2020-04-13,5,37,0,1009,397,4
香港,2020-04-14,3,37,0,1012,434,4
香港,2020-04-15,4,25,0,1016,459,4
香港,2020-04-16,1,26,0,1017,485,4
香港,2020-04-17,4,47,0,1021,532,4
香港,2020-04-18,2,36,0,1023,568,4
香港,2020-04-19,2,34,0,1025,602,4
香港,2020-04-20,0,28,0,1025,630,4
香港,2020-04-21,4,20,0,1029,650,4
香港,2020-04-22,4,28,0,1033,678,4
香港,2020-04-23,2,21,0,1035,699,4
香港,2020-04-24,0,26,0,1035,725,4
香港,2020-04-25,2,28,0,1037,753,4
香港,2020-04-26,0,19,0,1037,772,4
香港,2020-04-27,0,15,0,1037,787,4
香港,2020-04-28,0,24,0,1037,811,4
香港,2020-04-29,0,19,0,1037,830,4
香港,2020-04-30,0,16,0,1037,846,4
香港,2020-05-01,2,13,0,1039,859,4
香港,2020-05-02,0,5,0,1039,864,4
香港,2020-05-03,0,15,0,1039,879,4
香港,2020-05-04,1,21,0,1040,900,4
香港,2020-05-05,0,20,0,1040,920,4
香港,2020-05-06,0,12,0,1040,932,4
香港,2020-05-07,4,12,0,1044,944,4
香港,2020-05-08,0,16,0,1044,960,4
香港,2020-05-09,0,7,0,1044,967,4
香港,2020-05-10,3,15,0,1047,982,4
香港,2020-05-11,0,3,0,1047,985,4
香港,2020-05-12,0,6,0,1047,991,4
香港,2020-05-13,3,17,0,1050,1008,4
香港,2020-05-14,1,1,0,1051,1009,4
香港,2020-05-15,1,10,0,1052,1019,4
香港,2020-05-16,0,3,0,1052,1022,4
香港,2020-05-17,3,2,0,1055,1024,4
香港,2020-05-18,0,1,0,1055,1025,4
香港,2020-05-20,0,1,0,1055,1026,4
香港,2020-05-21,8,3,0,1063,1029,4
香港,2020-05-22,2,0,0,1065,1029,4
香港,2020-05-24,0,1,0,1065,1030,4
香港,2020-05-26,0,3,0,1065,1033,4
香港,2020-05-27,1,1,0,1066,1034,4
香港,2020-05-28,0,1,0,1066,1035,4
香港,2020-05-29,13,0,0,1079,1035,4
香港,2020-05-30,3,1,0,1082,1036,4
香港,2020-05-31,2,1,0,1084,1037,4
香港,2020-06-01,3,0,0,1087,1037,4
香港,2020-06-02,6,1,0,1093,1038,4
香港,2020-06-03,0,1,0,1093,1039,4
香港,2020-06-04,6,3,0,1099,1042,4
香港,2020-06-05,3,3,0,1102,1045,4
香港,2020-06-06,3,3,0,1105,1048,4
香港,2020-06-07,1,1,0,1106,1049,4
香港,2020-06-08,1,0,0,1107,1049,4
香港,2020-06-09,0,1,0,1107,1050,4
香港,2020-06-10,0,1,0,1107,1051,4
香港,2020-06-11,0,4,0,1107,1055,4
香港,2020-06-12,1,5,0,1108,1060,4
香港,2020-06-13,1,1,0,1109,1061,4
香港,2020-06-14,0,6,0,1109,1067,4
香港,2020-06-15,3,0,0,1112,1067,4
香港,2020-06-16,0,2,0,1112,1069,4
香港,2020-06-17,8,2,0,1120,1071,4
香港,2020-06-18,4,1,0,1124,1072,4
香港,2020-06-19,3,2,0,1127,1074,4
香港,2020-06-20,1,3,0,1128,1077,4
香港,2020-06-21,3,1,0,1131,1078,4
香港,2020-06-22,30,0,0,1161,1078,4
香港,2020-06-23,16,5,0,1177,1083,4
香港,2020-06-24,2,3,0,1179,1086,4
香港,2020-06-25,14,2,0,1193,1088,4
香港,2020-06-26,3,3,0,1196,1091,4
香港,2020-06-27,1,4,0,1197,1095,4
香港,2020-06-28,2,9,0,1199,1104,4
香港,2020-06-29,4,1,0,1203,1105,4
重庆,2020-01-22,2,0,0,2,0,0
重庆,2020-01-24,1,0,0,3,0,0
重庆,2020-02-02,0,1,0,3,1,0
重庆,2020-02-08,2,0,0,5,1,0
重庆,2020-02-14,0,1,0,5,2,0
重庆,2020-02-19,0,2,0,5,4,0
重庆,2020-02-25,0,1,0,5,5,0
湖南,2020-01-22,1,0,0,1,0,0
湖南,2020-01-23,3,0,0,4,0,0
湖南,2020-01-27,3,0,0,7,0,0
湖南,2020-01-28,4,0,0,11,0,0
湖南,2020-01-29,3,0,0,14,0,0
湖南,2020-01-30,2,0,0,16,0,0
湖南,2020-01-31,2,0,0,18,0,0
湖南,2020-02-01,4,2,0,22,2,0
湖南,2020-02-02,4,0,0,26,2,0
湖南,2020-02-03,0,3,0,26,5,0
湖南,2020-02-04,4,0,0,30,5,0
湖南,2020-02-05,2,3,0,32,8,0
湖南,2020-02-06,6,0,0,38,8,0
湖南,2020-02-07,2,2,0,40,10,0
湖南,2020-02-09,1,3,0,41,13,0
湖南,2020-02-10,1,0,0,42,13,0
湖南,2020-02-11,1,5,0,43,18,0
湖南,2020-02-13,0,5,0,43,23,0
湖南,2020-02-15,0,4,0,43,27,0
湖南,2020-02-16,0,1,0,43,28,0
湖南,2020-02-17,0,2,0,43,30,0
湖南,2020-02-21,0,5,0,43,35,0
湖南,2020-02-22,0,2,0,43,37,0
湖南,2020-02-24,0,4,0,43,41,0
湖南,2020-02-26,1,1,0,44,42,0
湖南,2020-03-01,0,1,0,44,43,0
湖南,2020-03-05,0,1,0,44,44,0
吉林,2020-01-22,1,0,0,1,0,0
吉林,2020-01-29,3,0,0,4,0,0
吉林,2020-01-30,0,1,0,4,1,0
吉林,2020-01-31,3,0,0,7,1,0
吉林,2020-02-01,6,0,0,13,1,0
吉林,2020-02-02,4,0,0,17,1,0
吉林,2020-02-03,1,0,0,18,1,0
吉林,2020-02-04,10,0,0,28,1,0
吉林,2020-02-05,1,0,0,29,1,0
吉林,2020-02-06,3,0,0,32,1,0
吉林,2020-02-08,5,0,0,37,1,0
吉林,2020-02-09,2,5,0,39,6,0
吉林,2020-02-10,1,0,0,40,6,0
吉林,2020-02-11,2,5,0,42,11,0
吉林,2020-02-13,1,2,0,43,13,0
吉林,2020-02-14,1,0,0,44,13,0
吉林,2020-02-15,1,1,0,45,14,0
吉林,2020-02-16,0,2,0,45,16,0
吉林,2020-02-17,0,3,0,45,19,0
吉林,2020-02-20,0,2,0,45,21,0
吉林,2020-02-21,0,1,0,45,22,0
吉林,2020-02-22,0,4,0,45,26,0
吉林,2020-02-23,0,1,0,45,27,0
吉林,2020-02-24,0,5,0,45,32,0
吉林,2020-02-25,0,1,0,45,33,0
吉林,2020-02-27,0,2,0,45,35,0
吉林,2020-02-28,0,2,0,45,37,0
吉林,2020-02-29,0,2,0,45,39,0
吉林,2020-03-02,0,1,0,45,40,0
吉林,2020-03-03,0,1,0,45,41,0
吉林,2020-03-04,0,2,0,45,43,0
吉林,2020-03-05,0,1,0,45,44,0
吉林,2020-03-09,0,1,0,45,45,0
广东,2020-01-22,1,0,0,1,0,0
广东,2020-01-24,1,0,0,2,0,0
广东,2020-01-25,2,0,0,4,0,0
广东,2020-01-28,1,0,0,5,0,0
广东,2020-01-30,1,0,0,6,0,0
广东,2020-01-31,0,1,0,6,1,0
广东,2020-02-01,1,0,0,7,1,0
广东,2020-02-03,3,0,0,10,1,0
广东,2020-02-04,1,0,0,11,1,0
广东,2020-02-05,2,0,0,13,1,0
广东,2020-02-06,1,0,1,14,1,1
广东,2020-02-08,0,2,0,14,3,1
广东,2020-02-10,1,1,0,15,4,1
广东,2020-02-11,1,3,0,16,7,1
广东,2020-02-13,1,0,0,17,7,1
广东,2020-02-15,0,1,0,17,8,1
广东,2020-02-17,1,0,0,18,8,1
广东,2020-02-21,1,0,0,19,8,1
广东,2020-02-22,0,2,0,19,10,1
广东,2020-02-26,0,3,0,19,13,1
广东,2020-03-01,0,1,0,19,14,1
广东,2020-01-22,1,0,0,1,0,0
广东,2020-01-23,1,0,0,2,0,0
广东,2020-01-26,2,0,0,4,0,0
广东,2020-01-27,2,0,0,6,0,0
广东,2020-01-28,6,0,0,12,0,0
广东,2020-01-29,4,0,0,16,0,0
广东,2020-01-30,2,0,0,18,0,0
广东,2020-02-01,3,0,0,21,0,0
广东,2020-02-02,4,0,0,25,0,0
广东,2020-02-03,6,0,0,31,0,0
广东,2020-02-04,4,2,0,35,2,0
广东,2020-02-05,9,1,0,44,3,0
广东,2020-02-06,2,2,0,46,5,0
广东,2020-02-07,0,5,0,46,10,0
广东,2020-02-08,5,3,0,51,13,0
广东,2020-02-09,5,0,0,56,13,0
广东,2020-02-10,2,2,0,58,15,0
广东,2020-02-11,4,5,0,62,20,0
广东,2020-02-12,2,1,0,64,21,0
广东,2020-02-13,0,4,0,64,25,0
广东,2020-02-14,1,5,0,65,30,0
广东,2020-02-15,0,3,0,65,33,0
广东,2020-02-16,1,1,0,66,34,0
广东,2020-02-17,0,5,0,66,39,0
广东,2020-02-18,0,1,0,66,40,0
广东,2020-02-19,0,2,0,66,42,0
广东,2020-02-20,0,1,0,66,43,0
广东,2020-02-21,0,3,0,66,46,0
广东,2020-02-23,0,3,0,66,49,0
广东,2020-02-24,0,2,0,66,51,0
广东,2020-02-25,0,2,0,66,53,0
广东,2020-02-27,0,2,0,66,55,0
广东,2020-02-28,0,3,0,66,58,0
广东,2020-03-02,0,1,0,66,59,0
广东,2020-03-03,0,1,0,66,60,0
广东,2020-03-04,0,1,0,66,61,0
广东,2020-03-05,0,1,0,66,62,0
广东,2020-03-11,0,1,0,66,63,0
广东,2020-03-12,0,1,0,66,64,0
广东,2020-04-17,1,0,0,67,64,0
陕西,2020-01-23,1,0,0,1,0,0
陕西,2020-01-24,2,0,0,3,0,0
陕西,2020-01-26,4,0,0,7,0,0
陕西,2020-01-27,1,0,0,8,0,0
陕西,2020-01-28,2,0,0,10,0,0
陕西,2020-01-30,3,0,0,13,0,0
陕西,2020-01-31,1,0,0,14,0,0
陕西,2020-02-01,2,0,0,16,0,0
陕西,2020-02-02,1,0,0,17,0,0
陕西,2020-02-04,2,0,0,19,0,0
陕西,2020-02-05,2,1,0,21,1,0
陕西,2020-02-09,1,4,0,22,5,0
陕西,2020-02-13,1,0,0,23,5,0
陕西,2020-02-14,1,0,0,24,5,0
陕西,2020-02-16,1,2,0,25,7,0
陕西,2020-02-18,0,3,0,25,10,0
陕西,2020-02-19,1,5,0,26,15,0
陕西,2020-02-23,0,2,0,26,17,0
陕西,2020-02-25,0,3,0,26,20,0
陕西,2020-02-29,0,3,0,26,23,0
陕西,2020-03-02,0,2,0,26,25,0
陕西,2020-03-11,0,1,0,26,26,0
安徽,2020-01-23,1,0,0,1,0,0
安徽,2020-01-24,3,0,0,4,0,0
安徽,2020-01-25,1,0,0,5,0,0
安徽,2020-01-26,3,0,0,8,0,0
安徽,2020-01-28,10,0,0,18,0,0
安徽,2020-01-29,6,0,0,24,0,0
安徽,2020-01-31,13,0,0,37,0,0
安徽,2020-02-01,6,0,0,43,0,0
安徽,2020-02-02,4,0,0,47,0,0
安徽,2020-02-03,8,0,0,55,0,0
安徽,2020-02-04,1,3,0,56,3,0
安徽,2020-02-05,4,0,0,60,3,0
安徽,2020-02-06,6,0,0,66,3,0
安徽,2020-02-07,5,3,0,71,6,0
安徽,2020-02-08,4,0,0,75,6,0
安徽,2020-02-09,3,6,0,78,12,0
安徽,2020-02-10,2,3,0,80,15,0
安徽,2020-02-13,1,14,0,81,29,0
安徽,2020-02-14,1,3,0,82,32,0
安徽,2020-02-15,0,1,0,82,33,0
安徽,2020-02-16,1,1,0,83,34,0
安徽,2020-02-18,0,5,0,83,39,0
安徽,2020-02-19,0,5,0,83,44,0
安徽,2020-02-20,0,9,0,83,53,0
安徽,2020-02-21,0,2,0,83,55,0
安徽,2020-02-22,0,6,0,83,61,0
安徽,2020-02-23,0,4,0,83,65,0
安徽,2020-02-24,0,4,0,83,69,0
安徽,2020-02-26,0,5,0,83,74,0
安徽,2020-02-27,0,5,0,83,79,0
安徽,2020-02-28,0,1,0,83,80,0
安徽,2020-03-01,0,2,0,83,82,0
安徽,2020-03-04,0,1,0,83,83,0
广西,2020-01-23,1,0,0,1,0,0
广西,2020-01-25,1,0,0,2,0,0
广西,2020-02-06,1,0,0,3,0,0
广西,2020-02-18,0,2,0,3,2,0
广西,2020-02-25,0,1,0,3,3,0
安徽,2020-01-23,1,0,0,1,0,0
安徽,2020-01-26,2,0,0,3,0,0
安徽,2020-01-29,5,0,0,8,0,0
安徽,2020-01-30,7,0,0,15,0,0
安徽,2020-01-31,1,0,0,16,0,0
安徽,2020-02-01,10,0,0,26,0,0
安徽,2020-02-02,11,0,0,37,0,0
安徽,2020-02-03,6,0,0,43,0,0
安徽,2020-02-04,5,0,0,48,0,0
安徽,2020-02-05,16,0,0,64,0,0
安徽,2020-02-06,24,0,0,88,0,0
安徽,2020-02-07,11,1,0,99,1,0
安徽,2020-02-08,16,0,1,115,1,1
安徽,2020-02-09,11,0,2,126,1,3
安徽,2020-02-10,8,1,0,134,2,3
安徽,2020-02-11,7,0,0,141,2,3
安徽,2020-02-12,5,0,1,146,2,4
安徽,2020-02-13,3,1,1,149,3,5
安徽,2020-02-14,4,4,0,153,7,5
安徽,2020-02-15,4,2,0,157,9,5
安徽,2020-02-16,1,4,0,158,13,5
安徽,2020-02-17,0,8,0,158,21,5
安徽,2020-02-18,1,9,0,159,30,5
安徽,2020-02-19,1,10,0,160,40,5
安徽,2020-02-20,0,16,0,160,56,5
安徽,2020-02-21,0,25,0,160,81,5
安徽,2020-02-22,0,20,0,160,101,5
安徽,2020-02-23,0,6,0,160,107,5
安徽,2020-02-24,0,6,0,160,113,5
安徽,2020-02-25,0,6,0,160,119,5
安徽,2020-02-26,0,8,0,160,127,5
安徽,2020-02-27,0,9,0,160,136,5
安徽,2020-02-28,0,5,0,160,141,5
安徽,2020-02-29,0,3,0,160,144,5
安徽,2020-03-01,0,2,0,160,146,5
安徽,2020-03-02,0,2,0,160,148,5
安徽,2020-03-03,0,4,0,160,152,5
安徽,2020-03-04,0,3,0,160,155,5
河北,2020-01-23,1,0,1,1,0,1
河北,2020-01-24,1,0,0,2,0,1
河北,2020-01-27,3,0,0,5,0,1
河北,2020-01-28,3,0,0,8,0,1
河北,2020-01-29,4,0,0,12,0,1
河北,2020-01-30,6,0,0,18,0,1
河北,2020-01-31,1,0,0,19,0,1
河北,2020-02-03,1,0,0,20,0,1
河北,2020-02-05,1,0,0,21,0,1
河北,2020-02-06,2,2,0,23,2,1
河北,2020-02-07,5,2,0,28,4,1
河北,2020-02-08,0,2,0,28,6,1
河北,2020-02-09,0,2,0,28,8,1
河北,2020-02-10,4,2,0,32,10,1
河北,2020-02-11,5,2,0,37,12,1
河北,2020-02-12,5,0,1,42,12,2
河北,2020-02-13,3,0,0,45,12,2
河北,2020-02-14,1,2,0,46,14,2
河北,2020-02-15,1,0,0,47,14,2
河北,2020-02-16,0,4,1,47,18,3
河北,2020-02-17,1,0,0,48,18,3
河北,2020-02-20,0,4,0,48,22,3
河北,2020-02-22,0,4,0,48,26,3
河北,2020-02-23,0,2,0,48,28,3
河北,2020-02-24,0,3,0,48,31,3
河北,2020-02-25,0,2,0,48,33,3
河北,2020-02-26,0,2,0,48,35,3
河北,2020-02-27,0,4,0,48,39,3
河北,2020-02-28,0,2,0,48,41,3
河北,2020-02-29,0,1,0,48,42,3
河北,2020-03-01,0,3,0,48,45,3
河北,2020-06-21,1,0,0,49,45,3
辽宁,2020-01-23,1,0,0,1,0,0
辽宁,2020-01-24,1,0,0,2,0,0
辽宁,2020-01-28,1,0,0,3,0,0
辽宁,2020-01-29,1,0,0,4,0,0
辽宁,2020-01-30,1,0,0,5,0,0
辽宁,2020-01-31,1,0,0,6,0,0
辽宁,2020-02-11,0,2,0,6,2,0
辽宁,2020-02-16,0,1,0,6,3,0
辽宁,2020-02-28,0,1,0,6,4,0
辽宁,2020-03-08,0,1,0,6,5,0
辽宁,2020-03-19,0,0,1,6,5,1
安徽,2020-01-23,1,0,0,1,0,0
安徽,2020-01-29,1,0,0,2,0,0
安徽,2020-01-30,2,0,0,4,0,0
安徽,2020-02-01,2,0,0,6,0,0
安徽,2020-02-03,4,1,0,10,1,0
安徽,2020-02-04,1,0,0,11,1,0
安徽,2020-02-08,1,0,0,12,1,0
安徽,2020-02-09,3,0,0,15,1,0
安徽,2020-02-10,0,2,0,15,3,0
安徽,2020-02-11,1,0,0,16,3,0
安徽,2020-02-13,1,0,0,17,3,0
安徽,2020-02-14,0,1,0,17,4,0
安徽,2020-02-16,0,2,0,17,6,0
安徽,2020-02-19,0,1,0,17,7,0
安徽,2020-02-20,0,3,0,17,10,0
安徽,2020-02-24,0,3,0,17,13,0
安徽,2020-03-01,0,2,0,17,15,0
安徽,2020-03-02,0,1,0,17,16,0
安徽,2020-03-05,0,1,0,17,17,0
重庆,2020-01-23,1,0,0,1,0,0
重庆,2020-01-24,1,0,0,2,0,0
重庆,2020-01-25,2,0,0,4,0,0
重庆,2020-01-26,2,0,0,6,0,0
重庆,2020-02-03,1,0,0,7,0,0
重庆,2020-02-06,0,1,0,7,1,0
重庆,2020-02-12,0,2,0,7,3,0
重庆,2020-02-13,0,1,0,7,4,0
重庆,2020-02-16,0,1,0,7,5,0
重庆,2020-02-22,0,1,0,7,6,0
重庆,2020-03-04,0,1,0,7,7,0
黑龙江,2020-01-23,1,0,0,1,0,0
黑龙江,2020-01-25,2,0,0,3,0,0
黑龙江,2020-01-26,2,0,0,5,0,0
黑龙江,2020-01-30,2,0,0,7,0,0
黑龙江,2020-01-31,1,0,0,8,0,0
黑龙江,2020-02-02,3,0,0,11,0,0
黑龙江,2020-02-05,2,0,1,13,0,1
黑龙江,2020-02-10,1,0,0,14,0,1
黑龙江,2020-02-11,1,0,0,15,0,1
黑龙江,2020-02-13,3,1,0,18,1,1
黑龙江,2020-02-14,1,0,0,19,1,1
黑龙江,2020-02-15,0,1,0,19,2,1
黑龙江,2020-02-16,1,1,0,20,3,1
黑龙江,2020-02-17,0,1,0,20,4,1
黑龙江,2020-02-18,3,3,0,23,7,1
黑龙江,2020-02-19,3,0,0,26,7,1
黑龙江,2020-02-20,0,1,0,26,8,1
黑龙江,2020-02-23,0,1,0,26,9,1
黑龙江,2020-02-24,0,3,0,26,12,1
黑龙江,2020-02-26,0,2,0,26,14,1
黑龙江,2020-02-27,0,2,0,26,16,1
黑龙江,2020-02-28,0,1,0,26,17,1
黑龙江,2020-03-01,0,1,0,26,18,1
黑龙江,2020-03-02,0,1,0,26,19,1
黑龙江,2020-03-03,0,1,0,26,20,1
黑龙江,2020-03-07,0,2,0,26,22,1
黑龙江,2020-03-09,0,1,0,26,23,1
黑龙江,2020-03-17,0,1,0,26,24,1
黑龙江,2020-03-21,0,1,0,26,25,1
黑龙江,2020-04-23,1,0,0,27,25,1
黑龙江,2020-05-06,0,1,0,27,26,1
四川,2020-01-23,1,0,0,1,0,0
四川,2020-01-28,1,0,0,2,0,0
四川,2020-01-29,1,0,0,3,0,0
四川,2020-01-30,4,0,0,7,0,0
四川,2020-02-01,3,0,0,10,0,0
四川,2020-02-03,2,0,0,12,0,0
四川,2020-02-07,1,0,0,13,0,0
四川,2020-02-08,3,0,0,16,0,0
四川,2020-02-12,1,0,0,17,0,0
四川,2020-02-17,0,1,0,17,1,0
四川,2020-02-20,1,2,0,18,3,0
四川,2020-02-21,0,2,0,18,5,0
四川,2020-02-22,0,1,0,18,6,0
四川,2020-02-23,0,1,0,18,7,0
四川,2020-02-25,0,2,0,18,9,0
四川,2020-02-27,0,1,0,18,10,0
四川,2020-03-02,0,1,0,18,11,0
四川,2020-03-03,0,1,0,18,12,0
四川,2020-03-04,0,1,0,18,13,0
四川,2020-03-05,0,1,0,18,14,0
四川,2020-03-07,0,4,0,18,18,0
重庆,2020-01-23,1,0,0,1,0,0
重庆,2020-01-25,2,0,0,3,0,0
重庆,2020-01-28,1,0,0,4,0,0
重庆,2020-01-30,1,0,0,5,0,0
重庆,2020-02-01,3,0,0,8,0,0
重庆,2020-02-02,1,0,0,9,0,0
重庆,2020-02-04,0,1,0,9,1,0
重庆,2020-02-05,2,0,0,11,1,0
重庆,2020-02-06,1,0,0,12,1,0
重庆,2020-02-07,1,0,0,13,1,0
重庆,2020-02-08,1,0,0,14,1,0
重庆,2020-02-11,3,1,0,17,2,0
重庆,2020-02-12,1,0,0,18,2,0
重庆,2020-02-13,2,1,0,20,3,0
重庆,2020-02-14,0,1,0,20,4,0
重庆,2020-02-15,0,1,0,20,5,0
重庆,2020-02-16,0,1,0,20,6,0
重庆,2020-02-18,0,1,0,20,7,0
重庆,2020-02-19,2,2,0,22,9,0
重庆,2020-02-20,0,1,0,22,10,0
重庆,2020-02-23,0,1,0,22,11,0
重庆,2020-02-24,0,1,0,22,12,0
重庆,2020-02-25,0,1,0,22,13,0
重庆,2020-02-27,0,4,0,22,17,0
重庆,2020-02-29,0,1,0,22,18,0
重庆,2020-03-03,0,1,0,22,19,0
重庆,2020-03-04,0,1,0,22,20,0
重庆,2020-03-09,0,2,0,22,22,0
广西,2020-01-23,2,0,0,2,0,0
广西,2020-01-24,4,0,0,6,0,0
广西,2020-01-25,5,0,0,11,0,0
广西,2020-01-26,3,0,0,14,0,0
广西,2020-01-27,1,0,0,15,0,0
广西,2020-01-28,1,0,0,16,0,0
广西,2020-01-29,2,0,0,18,0,0
广西,2020-01-31,3,0,0,21,0,0
广西,2020-02-01,2,0,0,23,0,0
广西,2020-02-02,1,0,0,24,0,0
广西,2020-02-03,0,4,0,24,4,0
广西,2020-02-04,2,0,0,26,4,0
广西,2020-02-05,1,1,0,27,5,0
广西,2020-02-06,1,0,0,28,5,0
广西,2020-02-07,1,0,0,29,5,0
广西,2020-02-09,1,0,0,30,5,0
广西,2020-02-11,1,0,0,31,5,0
广西,2020-02-15,0,5,0,31,10,0
广西,2020-02-17,0,2,0,31,12,0
广西,2020-02-18,0,3,0,31,15,0
广西,2020-02-21,1,2,0,32,17,0
广西,2020-02-24,0,6,0,32,23,0
广西,2020-02-26,0,1,0,32,24,0
广西,2020-02-29,0,2,0,32,26,0
广西,2020-03-01,0,1,0,32,27,0
广西,2020-03-02,0,1,0,32,28,0
广西,2020-03-03,0,2,0,32,30,0
广西,2020-03-04,0,1,0,32,31,0
广西,2020-03-10,0,1,0,32,32,0
天津,2020-01-23,1,0,0,1,0,0
天津,2020-01-24,1,0,0,2,0,0
天津,2020-01-26,3,0,0,5,0,0
天津,2020-01-27,2,0,0,7,0,0
天津,2020-01-30,1,0,0,8,0,0
天津,2020-02-01,1,0,0,9,0,0
天津,2020-02-04,1,0,0,10,0,0
天津,2020-02-08,0,1,0,10,1,0
天津,2020-02-10,0,1,0,10,2,0
天津,2020-02-11,1,0,0,11,2,0
天津,2020-02-12,1,0,0,12,2,0
天津,2020-02-13,0,1,0,12,3,0
天津,2020-02-14,0,4,0,12,7,0
天津,2020-02-18,0,1,0,12,8,0
天津,2020-02-19,0,1,0,12,9,0
天津,2020-02-21,0,1,0,12,10,0
天津,2020-03-02,0,1,0,12,11,0
天津,2020-03-11,0,1,0,12,12,0
广西,2020-01-23,1,0,0,1,0,0
广西,2020-01-24,2,0,0,3,0,0
广西,2020-01-29,2,0,0,5,0,0
广西,2020-01-30,1,0,0,6,0,0
广西,2020-02-03,2,0,0,8,0,0
广西,2020-02-04,1,0,0,9,0,0
广西,2020-02-05,2,0,0,11,0,0
广西,2020-02-07,4,0,0,15,0,0
广西,2020-02-08,4,0,1,19,0,1
广西,2020-02-09,2,0,0,21,0,1
广西,2020-02-14,1,0,0,22,0,1
广西,2020-02-18,1,0,0,23,0,1
广西,2020-02-19,0,4,0,23,4,1
广西,2020-02-20,1,0,0,24,4,1
广西,2020-02-21,1,0,0,25,4,1
广西,2020-02-23,2,0,0,27,4,1
广西,2020-02-24,1,1,0,28,5,1
广西,2020-02-26,0,3,0,28,8,1
广西,2020-03-01,0,2,0,28,10,1
广西,2020-03-02,0,3,0,28,13,1
广西,2020-03-03,0,2,0,28,15,1
广西,2020-03-04,0,1,0,28,16,1
广西,2020-03-06,0,1,0,28,17,1
广西,2020-03-07,0,1,0,28,18,1
广西,2020-03-08,0,4,0,28,22,1
广西,2020-03-09,0,2,0,28,24,1
广西,2020-03-11,0,2,0,28,26,1
广西,2020-03-12,0,1,0,28,27,1
内蒙古,2020-01-23,1,0,0,1,0,0
内蒙古,2020-01-25,1,0,0,2,0,0
内蒙古,2020-01-31,0,1,0,2,1,0
内蒙古,2020-02-03,1,0,0,3,1,0
内蒙古,2020-02-05,2,0,0,5,1,0
内蒙古,2020-02-11,1,0,0,6,1,0
内蒙古,2020-02-18,1,0,0,7,1,0
内蒙古,2020-02-20,0,1,0,7,2,0
内蒙古,2020-02-22,0,2,0,7,4,0
内蒙古,2020-02-29,0,1,0,7,5,0
内蒙古,2020-03-04,0,2,0,7,7,0
内蒙古,2020-04-19,1,0,0,8,7,0
内蒙古,2020-04-30,1,0,0,9,7,0
内蒙古,2020-05-05,0,1,0,9,8,0
内蒙古,2020-05-20,0,1,0,9,9,0
江西,2020-01-23,1,0,0,1,0,0
江西,2020-01-25,1,0,0,2,0,0
江西,2020-01-26,1,0,0,3,0,0
江西,2020-01-27,0,1,0,3,1,0
江西,2020-01-28,1,0,0,4,1,0
江西,2020-01-29,1,0,0,5,1,0
江西,2020-01-30,3,0,0,8,1,0
江西,2020-01-31,3,0,0,11,1,0
江西,2020-02-01,1,0,0,12,1,0
江西,2020-02-02,1,0,0,13,1,0
江西,2020-02-03,2,0,0,15,1,0
江西,2020-02-06,1,0,0,16,1,0
江西,2020-02-07,1,0,0,17,1,0
江西,2020-02-09,1,1,0,18,2,0
江西,2020-02-10,1,2,0,19,4,0
江西,2020-02-11,1,1,0,20,5,0
江西,2020-02-14,0,1,0,20,6,0
江西,2020-02-15,1,2,0,21,8,0
江西,2020-02-16,0,1,0,21,9,0
江西,2020-02-17,1,0,0,22,9,0
江西,2020-02-18,0,1,0,22,10,0
江西,2020-02-23,0,2,0,22,12,0
江西,2020-02-25,0,1,0,22,13,0
江西,2020-02-27,0,2,0,22,15,0
江西,2020-02-29,0,3,0,22,18,0
江西,2020-03-02,0,2,0,22,20,0
江西,2020-03-05,0,1,0,22,21,0
江西,2020-03-06,0,1,0,22,22,0
吉林,2020-01-23,1,0,0,1,0,0
吉林,2020-01-24,1,0,0,2,0,0
吉林,2020-01-27,1,0,0,3,0,0
吉林,2020-02-02,1,0,0,4,0,0
吉林,2020-02-03,1,0,0,5,0,0
吉林,2020-02-05,0,1,0,5,1,0
吉林,2020-02-06,0,1,0,5,2,0
吉林,2020-02-12,0,1,0,5,3,0
吉林,2020-02-20,0,1,0,5,4,0
吉林,2020-02-22,0,1,0,5,5,0
吉林,2020-05-07,1,0,0,6,5,0
吉林,2020-05-09,11,0,0,17,5,0
吉林,2020-05-10,3,0,0,20,5,0
吉林,2020-05-12,6,0,0,26,5,0
吉林,2020-05-13,1,0,0,27,5,0
吉林,2020-05-14,4,0,0,31,5,0
吉林,2020-05-15,2,0,0,33,5,0
吉林,2020-05-16,4,3,1,37,8,1
吉林,2020-05-17,2,8,0,39,16,1
吉林,2020-05-18,5,1,0,44,17,1
吉林,2020-05-19,1,2,0,45,19,1
吉林,2020-05-21,2,2,0,47,21,1
吉林,2020-05-22,0,1,0,47,22,1
吉林,2020-05-23,1,0,0,48,22,1
吉林,2020-05-27,0,5,0,48,27,1
吉林,2020-05-28,0,3,0,48,30,1
吉林,2020-05-29,0,6,0,48,36,1
吉林,2020-05-30,0,2,0,48,38,1
吉林,2020-06-01,0,3,0,48,41,1
吉林,2020-06-03,0,1,0,48,42,1
吉林,2020-06-04,0,1,0,48,43,1
吉林,2020-06-05,0,1,0,48,44,1
吉林,2020-06-06,0,1,0,48,45,1
吉林,2020-06-07,0,2,0,48,47,1
浙江,2020-01-23,3,0,0,3,0,0
浙江,2020-01-24,1,0,0,4,0,0
浙江,2020-01-25,4,0,0,8,0,0
浙江,2020-01-27,3,0,0,11,0,0
浙江,2020-01-28,3,0,0,14,0,0
浙江,2020-01-29,2,0,0,16,0,0
浙江,2020-01-31,2,0,0,18,0,0
浙江,2020-02-01,1,0,0,19,0,0
浙江,2020-02-03,4,0,0,23,0,0
浙江,2020-02-04,4,0,0,27,0,0
浙江,2020-02-05,3,0,0,30,0,0
浙江,2020-02-06,5,1,0,35,1,0
浙江,2020-02-07,2,0,0,37,1,0
浙江,2020-02-08,1,0,0,38,1,0
浙江,2020-02-09,2,2,0,40,3,0
浙江,2020-02-10,0,2,0,40,5,0
浙江,2020-02-11,2,1,0,42,6,0
浙江,2020-02-13,0,2,0,42,8,0
浙江,2020-02-14,1,2,0,43,10,0
浙江,2020-02-15,0,1,0,43,11,0
浙江,2020-02-17,0,3,0,43,14,0
浙江,2020-02-18,1,1,0,44,15,0
浙江,2020-02-19,1,5,0,45,20,0
浙江,2020-02-20,0,2,0,45,22,0
浙江,2020-02-22,0,1,0,45,23,0
浙江,2020-02-23,0,2,0,45,25,0
浙江,2020-02-24,0,3,0,45,28,0
浙江,2020-02-26,0,4,0,45,32,0
浙江,2020-02-28,0,3,0,45,35,0
浙江,2020-02-29,0,3,0,45,38,0
浙江,2020-03-01,0,3,0,45,41,0
浙江,2020-03-07,0,1,0,45,42,0
浙江,2020-03-09,0,1,0,45,43,0
浙江,2020-03-13,0,1,0,45,44,0
浙江,2020-03-22,0,1,0,45,45,0
浙江,2020-03-26,1,0,0,46,45,0
浙江,2020-04-13,0,1,0,46,46,0
江西,2020-01-23,1,0,0,1,0,0
江西,2020-01-24,1,0,0,2,0,0
江西,2020-01-26,2,0,0,4,0,0
江西,2020-01-27,5,0,0,9,0,0
江西,2020-01-28,7,0,0,16,0,0
江西,2020-01-29,15,0,0,31,0,0
江西,2020-01-30,11,0,0,42,0,0
江西,2020-01-31,1,0,0,43,0,0
江西,2020-02-01,12,0,0,55,0,0
江西,2020-02-02,9,2,0,64,2,0
江西,2020-02-03,14,0,0,78,2,0
江西,2020-02-04,8,0,0,86,2,0
江西,2020-02-05,6,1,0,92,3,0
江西,2020-02-06,3,1,0,95,4,0
江西,2020-02-07,2,0,0,97,4,0
江西,2020-02-08,3,2,0,100,6,0
江西,2020-02-09,1,1,0,101,7,0
江西,2020-02-10,0,6,0,101,13,0
江西,2020-02-11,4,1,0,105,14,0
江西,2020-02-12,4,0,0,109,14,0
江西,2020-02-13,5,2,0,114,16,0
江西,2020-02-14,1,2,0,115,18,0
江西,2020-02-15,2,4,0,117,22,0
江西,2020-02-17,1,8,0,118,30,0
江西,2020-02-18,0,3,0,118,33,0
江西,2020-02-19,0,11,0,118,44,0
江西,2020-02-20,0,3,0,118,47,0
江西,2020-02-22,0,4,0,118,51,0
江西,2020-02-23,0,6,0,118,57,0
江西,2020-02-24,0,5,0,118,62,0
江西,2020-02-25,0,9,0,118,71,0
江西,2020-02-26,0,9,0,118,80,0
江西,2020-02-27,0,11,0,118,91,0
江西,2020-02-28,0,3,0,118,94,0
江西,2020-03-01,0,3,0,118,97,0
江西,2020-03-02,0,1,0,118,98,0
江西,2020-03-03,0,3,0,118,101,0
江西,2020-03-04,0,7,0,118,108,0
江西,2020-03-05,0,2,0,118,110,0
江西,2020-03-06,0,2,0,118,112,0
江西,2020-03-08,0,1,0,118,113,0
江西,2020-03-09,0,2,0,118,115,0
江西,2020-03-10,0,2,0,118,117,0
江西,2020-03-11,0,1,0,118,118,0
重庆,2020-01-23,2,0,0,2,0,0
重庆,2020-01-24,1,0,0,3,0,0
重庆,2020-01-26,1,0,0,4,0,0
重庆,2020-01-27,1,0,0,5,0,0
重庆,2020-01-30,3,0,0,8,0,0
重庆,2020-01-31,1,0,1,9,0,1
重庆,2020-02-01,2,0,0,11,0,1
重庆,2020-02-02,2,0,0,13,0,1
重庆,2020-02-03,2,0,0,15,0,1
重庆,2020-02-04,4,0,0,19,0,1
重庆,2020-02-08,0,1,0,19,1,1
重庆,2020-02-09,1,0,0,20,1,1
重庆,2020-02-12,0,2,0,20,3,1
重庆,2020-02-15,0,4,0,20,7,1
重庆,2020-02-16,0,1,0,20,8,1
重庆,2020-02-17,0,2,0,20,10,1
重庆,2020-02-21,0,1,0,20,11,1
重庆,2020-02-24,1,0,0,21,11,1
重庆,2020-02-25,0,1,0,21,12,1
重庆,2020-02-27,0,1,0,21,13,1
重庆,2020-02-28,0,2,0,21,15,1
重庆,2020-03-01,0,1,0,21,16,1
重庆,2020-03-02,0,1,0,21,17,1
重庆,2020-03-03,0,1,0,21,18,1
重庆,2020-03-12,0,2,0,21,20,1
重庆,2020-01-23,2,0,0,2,0,0
重庆,2020-01-24,2,0,0,4,0,0
重庆,2020-01-26,3,0,0,7,0,0
重庆,2020-01-27,2,0,0,9,0,0
重庆,2020-01-28,2,0,0,11,0,0
重庆,2020-01-29,2,0,0,13,0,0
重庆,2020-01-30,3,0,0,16,0,0
重庆,2020-02-02,1,0,0,17,0,0
重庆,2020-02-03,1,0,0,18,0,0
重庆,2020-02-06,0,2,0,18,2,0
重庆,2020-02-09,0,3,0,18,5,0
重庆,2020-02-10,0,1,0,18,6,0
重庆,2020-02-11,2,4,1,20,10,1
重庆,2020-02-12,0,1,0,20,11,1
重庆,2020-02-13,0,1,0,20,12,1
重庆,2020-02-16,0,1,0,20,13,1
重庆,2020-02-19,0,1,0,20,14,1
重庆,2020-02-20,0,1,0,20,15,1
重庆,2020-02-21,1,1,0,21,16,1
重庆,2020-02-24,0,2,0,21,18,1
重庆,2020-02-27,0,1,0,21,19,1
重庆,2020-03-05,0,1,0,21,20,1
江苏,2020-01-23,1,0,0,1,0,0
江苏,2020-01-25,2,0,0,3,0,0
江苏,2020-01-29,3,0,0,6,0,0
江苏,2020-01-30,3,0,0,9,0,0
江苏,2020-01-31,4,1,0,13,1,0
江苏,2020-02-02,1,0,0,14,1,0
江苏,2020-02-03,3,0,0,17,1,0
江苏,2020-02-04,3,0,0,20,1,0
江苏,2020-02-05,2,0,0,22,1,0
江苏,2020-02-06,2,1,0,24,2,0
江苏,2020-02-07,3,0,0,27,2,0
江苏,2020-02-08,5,0,0,32,2,0
江苏,2020-02-09,3,2,0,35,4,0
江苏,2020-02-10,2,0,0,37,4,0
江苏,2020-02-11,2,1,0,39,5,0
江苏,2020-02-12,3,0,0,42,5,0
江苏,2020-02-13,3,1,0,45,6,0
江苏,2020-02-14,1,4,0,46,10,0
江苏,2020-02-15,2,2,0,48,12,0
江苏,2020-02-16,0,1,0,48,13,0
江苏,2020-02-17,0,1,0,48,14,0
江苏,2020-02-18,0,3,0,48,17,0
江苏,2020-02-19,0,1,0,48,18,0
江苏,2020-02-21,0,4,0,48,22,0
江苏,2020-02-23,0,2,0,48,24,0
江苏,2020-02-24,0,1,0,48,25,0
江苏,2020-02-25,0,2,0,48,27,0
江苏,2020-02-26,0,6,0,48,33,0
江苏,2020-02-27,0,2,0,48,35,0
江苏,2020-02-29,0,2,0,48,37,0
江苏,2020-03-02,0,4,0,48,41,0
江苏,2020-03-03,0,1,0,48,42,0
江苏,2020-03-06,0,1,0,48,43,0
江苏,2020-03-07,0,2,0,48,45,0
江苏,2020-03-08,0,2,0,48,47,0
江苏,2020-03-09,0,1,0,48,48,0
重庆,2020-01-23,1,0,0,1,0,0
重庆,2020-01-24,2,0,0,3,0,0
重庆,2020-01-26,4,0,0,7,0,0
重庆,2020-01-27,1,0,0,8,0,0
重庆,2020-01-30,1,0,0,9,0,0
重庆,2020-01-31,1,0,0,10,0,0
重庆,2020-02-01,2,0,0,12,0,0
重庆,2020-02-03,1,0,0,13,0,0
重庆,2020-02-04,1,0,0,14,0,0
重庆,2020-02-07,2,0,0,16,0,0
重庆,2020-02-11,0,1,0,16,1,0
重庆,2020-02-12,1,2,0,17,3,0
重庆,2020-02-13,0,1,0,17,4,0
重庆,2020-02-15,0,3,0,17,7,0
重庆,2020-02-22,0,3,0,17,10,0
重庆,2020-02-26,0,2,0,17,12,0
重庆,2020-02-27,0,1,0,17,13,0
重庆,2020-02-28,0,1,0,17,14,0
重庆,2020-03-01,0,1,0,17,15,0
重庆,2020-03-09,0,1,0,17,16,0
重庆,2020-03-11,0,1,0,17,17,0
湖南,2020-01-23,3,0,0,3,0,0
湖南,2020-01-24,2,0,0,5,0,0
湖南,2020-01-26,2,0,0,7,0,0
湖南,2020-01-27,2,0,0,9,0,0
湖南,2020-01-28,4,0,0,13,0,0
湖南,2020-01-29,3,0,0,16,0,0
湖南,2020-01-30,4,0,0,20,0,0
湖南,2020-01-31,6,0,0,26,0,0
湖南,2020-02-01,3,1,0,29,1,0
湖南,2020-02-02,6,0,0,35,1,0
湖南,2020-02-03,5,1,0,40,2,0
湖南,2020-02-04,5,1,0,45,3,0
湖南,2020-02-05,6,0,0,51,3,0
湖南,2020-02-06,2,1,0,53,4,0
湖南,2020-02-07,6,0,0,59,4,0
湖南,2020-02-08,5,4,0,64,8,0
湖南,2020-02-09,2,0,0,66,8,0
湖南,2020-02-10,3,4,0,69,12,0
湖南,2020-02-11,0,6,0,69,18,0
湖南,2020-02-12,3,4,0,72,22,0
湖南,2020-02-13,1,3,0,73,25,0
湖南,2020-02-14,2,4,0,75,29,0
湖南,2020-02-15,0,5,0,75,34,0
湖南,2020-02-16,1,1,0,76,35,0
湖南,2020-02-18,0,12,0,76,47,0
湖南,2020-02-19,0,4,0,76,51,0
湖南,2020-02-20,0,3,0,76,54,0
湖南,2020-02-23,0,1,0,76,55,0
湖南,2020-02-24,0,1,0,76,56,0
湖南,2020-02-25,0,1,0,76,57,0
湖南,2020-02-26,0,1,0,76,58,0
湖南,2020-02-27,0,2,0,76,60,0
湖南,2020-02-29,0,2,0,76,62,0
湖南,2020-03-02,0,4,0,76,66,0
湖南,2020-03-03,0,1,0,76,67,0
湖南,2020-03-04,0,1,0,76,68,0
湖南,2020-03-05,0,2,0,76,70,0
湖南,2020-03-06,0,1,0,76,71,0
湖南,2020-03-08,0,3,0,76,74,0
湖南,2020-03-12,0,1,0,76,75,0
湖南,2020-03-13,0,1,0,76,76,0
江苏,2020-01-23,3,0,0,3,0,0
江苏,2020-01-24,1,0,0,4,0,0
江苏,2020-01-25,3,0,0,7,0,0
江苏,2020-01-27,3,0,0,10,0,0
江苏,2020-01-28,4,0,0,14,0,0
江苏,2020-01-29,5,0,0,19,0,0
江苏,2020-01-30,6,0,0,25,0,0
江苏,2020-01-31,3,2,0,28,2,0
江苏,2020-02-01,7,0,0,35,2,0
江苏,2020-02-02,5,0,0,40,2,0
江苏,2020-02-03,4,0,0,44,2,0
江苏,2020-02-04,3,2,0,47,4,0
江苏,2020-02-05,5,7,0,52,11,0
江苏,2020-02-06,5,2,0,57,13,0
江苏,2020-02-07,8,2,0,65,15,0
江苏,2020-02-08,6,5,0,71,20,0
江苏,2020-02-09,7,2,0,78,22,0
江苏,2020-02-10,6,0,0,84,22,0
江苏,2020-02-11,3,0,0,87,22,0
江苏,2020-02-12,3,2,0,90,24,0
江苏,2020-02-13,1,2,0,91,26,0
江苏,2020-02-14,0,1,0,91,27,0
江苏,2020-02-15,1,2,0,92,29,0
江苏,2020-02-16,0,3,0,92,32,0
江苏,2020-02-18,1,3,0,93,35,0
江苏,2020-02-19,0,3,0,93,38,0
江苏,2020-02-20,0,9,0,93,47,0
江苏,2020-02-21,0,5,0,93,52,0
江苏,2020-02-24,0,5,0,93,57,0
江苏,2020-02-25,0,1,0,93,58,0
江苏,2020-03-01,0,5,0,93,63,0
江苏,2020-03-02,0,5,0,93,68,0
江苏,2020-03-03,0,6,0,93,74,0
江苏,2020-03-04,0,6,0,93,80,0
江苏,2020-03-05,0,3,0,93,83,0
江苏,2020-03-06,0,6,0,93,89,0
江苏,2020-03-07,0,3,0,93,92,0
江苏,2020-03-08,0,1,0,93,93,0
江苏,2020-01-23,1,0,0,1,0,0
江苏,2020-01-25,1,0,0,2,0,0
江苏,2020-01-26,2,0,0,4,0,0
江苏,2020-01-27,2,0,0,6,0,0
江苏,2020-01-29,3,0,0,9,0,0
江苏,2020-01-30,1,0,0,10,0,0
江苏,2020-01-31,2,0,0,12,0,0
江苏,2020-02-01,5,0,0,17,0,0
江苏,2020-02-02,2,0,0,19,0,0
江苏,2020-02-03,3,0,0,22,0,0
江苏,2020-02-04,3,0,0,25,0,0
江苏,2020-02-05,2,0,0,27,0,0
江苏,2020-02-06,2,2,0,29,2,0
江苏,2020-02-07,2,0,0,31,2,0
江苏,2020-02-08,1,0,0,32,2,0
江苏,2020-02-09,1,0,0,33,2,0
江苏,2020-02-10,2,3,0,35,5,0
江苏,2020-02-11,2,0,0,37,5,0
江苏,2020-02-12,1,5,0,38,10,0
江苏,2020-02-13,1,0,0,39,10,0
江苏,2020-02-14,1,3,0,40,13,0
江苏,2020-02-15,0,2,0,40,15,0
江苏,2020-02-16,0,1,0,40,16,0
江苏,2020-02-17,0,3,0,40,19,0
江苏,2020-02-18,0,2,0,40,21,0
江苏,2020-02-19,0,2,0,40,23,0
江苏,2020-02-21,0,5,0,40,28,0
江苏,2020-02-22,0,4,0,40,32,0
江苏,2020-02-23,0,1,0,40,33,0
江苏,2020-02-24,0,1,0,40,34,0
江苏,2020-02-25,0,1,0,40,35,0
江苏,2020-02-26,0,2,0,40,37,0
江苏,2020-03-02,0,3,0,40,40,0
福建,2020-01-23,1,0,0,1,0,0
福建,2020-01-25,1,0,0,2,0,0
福建,2020-01-26,1,0,0,3,0,0
福建,2020-01-27,3,0,0,6,0,0
福建,2020-01-28,1,0,0,7,0,0
福建,2020-01-29,1,0,0,8,0,0
福建,2020-01-30,1,0,0,9,0,0
福建,2020-02-02,3,0,0,12,0,0
福建,2020-02-04,2,1,0,14,1,0
福建,2020-02-05,2,0,0,16,1,0
福建,2020-02-07,5,3,0,21,4,0
福建,2020-02-08,2,0,0,23,4,0
福建,2020-02-09,1,0,0,24,4,0
福建,2020-02-12,1,1,0,25,5,0
福建,2020-02-13,0,1,0,25,6,0
福建,2020-02-18,1,0,0,26,6,0
福建,2020-02-19,0,6,0,26,12,0
福建,2020-02-20,0,5,0,26,17,0
福建,2020-02-22,0,3,0,26,20,0
福建,2020-02-26,0,3,0,26,23,0
福建,2020-03-04,0,1,0,26,24,0
福建,2020-03-06,0,2,0,26,26,0
广东,2020-01-23,1,0,0,1,0,0
广东,2020-01-24,1,0,0,2,0,0
广东,2020-01-25,1,0,0,3,0,0
广东,2020-01-27,2,0,0,5,0,0
广东,2020-01-28,1,0,0,6,0,0
广东,2020-01-30,0,1,0,6,1,0
广东,2020-02-02,0,1,0,6,2,0
广东,2020-02-03,2,0,0,8,2,0
广东,2020-02-04,2,0,0,10,2,0
广东,2020-02-07,0,1,0,10,3,0
广东,2020-02-10,0,2,0,10,5,0
广东,2020-02-11,2,0,0,12,5,0
广东,2020-02-14,0,2,0,12,7,0
广东,2020-02-17,0,2,0,12,9,0
广东,2020-02-22,0,1,0,12,10,0
广东,2020-02-24,0,2,0,12,12,0
福建,2020-01-23,1,0,0,1,0,0
福建,2020-01-25,2,0,0,3,0,0
福建,2020-01-26,2,0,0,5,0,0
福建,2020-01-27,5,0,0,10,0,0
福建,2020-01-28,3,0,0,13,0,0
福建,2020-01-29,5,0,0,18,0,0
福建,2020-01-30,4,0,0,22,0,0
福建,2020-01-31,2,0,0,24,0,0
福建,2020-02-01,5,0,0,29,0,0
福建,2020-02-02,2,0,0,31,0,0
福建,2020-02-03,4,0,0,35,0,0
福建,2020-02-04,2,3,0,37,3,0
福建,2020-02-05,2,1,0,39,4,0
福建,2020-02-06,1,0,0,40,4,0
福建,2020-02-08,2,0,0,42,4,0
福建,2020-02-09,0,6,0,42,10,0
福建,2020-02-10,1,1,0,43,11,0
福建,2020-02-12,1,2,0,44,13,0
福建,2020-02-14,2,0,0,46,13,0
福建,2020-02-20,0,3,0,46,16,0
福建,2020-02-21,0,1,0,46,17,0
福建,2020-02-22,0,2,0,46,19,0
福建,2020-02-23,0,2,0,46,21,0
福建,2020-02-24,1,0,0,47,21,0
福建,2020-02-25,0,2,0,47,23,0
福建,2020-02-26,0,6,0,47,29,0
福建,2020-02-27,0,1,0,47,30,0
福建,2020-02-28,0,1,0,47,31,0
福建,2020-02-29,0,1,0,47,32,0
福建,2020-03-02,0,8,0,47,40,0
福建,2020-03-03,0,1,0,47,41,0
福建,2020-03-04,0,2,0,47,43,0
福建,2020-03-05,0,2,0,47,45,0
福建,2020-03-06,0,2,0,47,47,0
山东,2020-01-23,1,0,0,1,0,0
山东,2020-01-24,1,0,0,2,0,0
山东,2020-01-25,2,0,0,4,0,0
山东,2020-01-26,1,0,0,5,0,0
山东,2020-01-27,1,0,0,6,0,0
山东,2020-01-28,1,0,0,7,0,0
山东,2020-01-29,1,0,0,8,0,0
山东,2020-01-30,1,0,0,9,0,0
山东,2020-01-31,1,0,0,10,0,0
山东,2020-02-01,1,0,0,11,0,0
山东,2020-02-02,1,0,0,12,0,0
山东,2020-02-03,2,0,0,14,0,0
山东,2020-02-06,0,2,0,14,2,0
山东,2020-02-08,1,0,0,15,2,0
山东,2020-02-15,1,1,0,16,3,0
山东,2020-02-17,0,1,0,16,4,0
山东,2020-02-18,0,2,0,16,6,0
山东,2020-02-19,0,1,0,16,7,0
山东,2020-02-20,0,1,0,16,8,0
山东,2020-02-21,0,1,0,16,9,0
山东,2020-02-22,0,1,0,16,10,0
山东,2020-02-23,0,1,0,16,11,0
山东,2020-02-26,0,1,0,16,12,0
山东,2020-02-29,0,2,0,16,14,0
山东,2020-03-01,0,1,0,16,15,0
山东,2020-03-09,0,1,0,16,16,0
福建,2020-01-23,1,0,0,1,0,0
福建,2020-01-24,2,0,0,3,0,0
福建,2020-01-26,1,0,0,4,0,0
福建,2020-01-28,2,0,0,6,0,0
福建,2020-01-29,1,0,0,7,0,0
福建,2020-01-30,6,0,0,13,0,0
福建,2020-01-31,4,0,0,17,0,0
福建,2020-02-01,1,0,0,18,0,0
福建,2020-02-02,1,0,0,19,0,0
福建,2020-02-03,1,0,0,20,0,0
福建,2020-02-04,1,0,0,21,0,0
福建,2020-02-05,0,1,0,21,1,0
福建,2020-02-06,2,1,0,23,2,0
福建,2020-02-07,2,0,0,25,2,0
福建,2020-02-09,3,1,0,28,3,0
福建,2020-02-10,3,0,0,31,3,0
福建,2020-02-11,1,1,0,32,4,0
福建,2020-02-12,2,0,0,34,4,0
福建,2020-02-15,0,2,0,34,6,0
福建,2020-02-16,1,0,0,35,6,0
福建,2020-02-17,0,3,0,35,9,0
福建,2020-02-18,0,1,0,35,10,0
福建,2020-02-20,0,5,0,35,15,0
福建,2020-02-21,0,2,0,35,17,0
福建,2020-02-22,0,2,0,35,19,0
福建,2020-02-23,0,4,0,35,23,0
福建,2020-02-24,0,4,0,35,27,0
福建,2020-02-25,0,3,0,35,30,0
福建,2020-02-26,0,1,0,35,31,0
福建,2020-02-27,0,3,0,35,34,0
福建,2020-03-03,0,1,0,35,35,0
湖北,2020-01-23,1,0,0,1,0,0
湖北,2020-01-24,4,0,0,5,0,0
湖北,2020-01-25,15,0,0,20,0,0
湖北,2020-01-26,20,0,0,40,0,0
湖北,2020-01-27,25,0,0,65,0,0
湖北,2020-01-28,23,0,0,88,0,0
湖北,2020-01-29,31,0,0,119,0,0
湖北,2020-01-30,31,0,0,150,0,0
湖北,2020-01-31,27,0,0,177,0,0
湖北,2020-02-01,35,0,0,212,0,0
湖北,2020-02-02,44,2,0,256,2,0
湖北,2020-02-03,35,4,0,291,6,0
湖北,2020-02-04,27,3,0,318,9,0
湖北,2020-02-05,35,5,0,353,14,0
湖北,2020-02-06,42,10,0,395,24,0
湖北,2020-02-07,43,9,0,438,33,0
湖北,2020-02-08,29,7,0,467,40,0
湖北,2020-02-09,14,6,0,481,46,0
湖北,2020-02-10,24,13,1,505,59,1
湖北,2020-02-11,31,11,0,536,70,1
湖北,2020-02-12,26,11,0,562,81,1
湖北,2020-02-13,24,8,1,586,89,2
湖北,2020-02-14,11,11,0,597,100,2
湖北,2020-02-15,5,16,0,602,116,2
湖北,2020-02-16,10,10,0,612,126,2
湖北,2020-02-17,14,18,0,626,144,2
湖北,2020-02-18,12,20,0,638,164,2
湖北,2020-02-19,5,23,0,643,187,2
湖北,2020-02-20,13,22,0,656,209,2
湖北,2020-02-21,3,30,0,659,239,2
湖北,2020-02-22,8,28,0,667,267,2
湖北,2020-02-23,2,26,0,669,293,2
湖北,2020-02-24,2,22,1,671,315,3
湖北,2020-02-25,0,33,0,671,348,3
湖北,2020-02-26,0,24,0,671,372,3
湖北,2020-02-27,0,17,3,671,389,6
湖北,2020-02-28,0,32,1,671,421,7
湖北,2020-02-29,1,20,0,672,441,7
湖北,2020-03-01,0,18,0,672,459,7
湖北,2020-03-02,0,32,0,672,491,7
湖北,2020-03-03,0,14,0,672,505,7
湖北,2020-03-04,0,22,0,672,527,7
湖北,2020-03-05,0,12,1,672,539,8
湖北,2020-03-06,0,14,0,672,553,8
湖北,2020-03-07,0,18,0,672,571,8
湖北,2020-03-08,0,17,0,672,588,8
湖北,2020-03-09,0,8,0,672,596,8
湖北,2020-03-10,0,8,0,672,604,8
湖北,2020-03-11,0,10,0,672,614,8
湖北,2020-03-12,0,12,0,672,626,8
湖北,2020-03-13,0,3,0,672,629,8
湖北,2020-03-14,0,1,0,672,630,8
湖北,2020-03-15,0,4,0,672,634,8
湖北,2020-03-16,0,4,0,672,638,8
湖北,2020-03-17,0,7,0,672,645,8
湖北,2020-03-18,0,10,0,672,655,8
湖北,2020-03-19,0,6,0,672,661,8
湖北,2020-03-20,0,2,0,672,663,8
湖北,2020-03-22,0,1,0,672,664,8
北京,2020-01-23,1,0,0,1,0,0
北京,2020-01-27,1,0,0,2,0,0
北京,2020-02-01,3,0,0,5,0,0
北京,2020-02-04,1,0,0,6,0,0
北京,2020-02-05,0,6,0,6,6,0
北京,2020-02-06,2,0,0,8,6,0
北京,2020-02-07,1,0,0,9,6,0
北京,2020-02-08,1,0,0,10,6,0
吉林,2020-01-23,1,0,0,1,0,0
吉林,2020-01-26,1,0,0,2,0,0
吉林,2020-02-08,0,1,0,2,1,0
吉林,2020-02-19,0,1,0,2,2,0
黑龙江,2020-01-23,1,0,1,1,0,1
黑龙江,2020-01-25,1,0,0,2,0,1
黑龙江,2020-01-26,1,0,0,3,0,1
黑龙江,2020-01-27,5,0,0,8,0,1
黑龙江,2020-01-29,2,0,0,10,0,1
黑龙江,2020-01-30,2,0,1,12,0,2
黑龙江,2020-01-31,1,0,0,13,0,2
黑龙江,2020-02-01,1,0,0,14,0,2
黑龙江,2020-02-02,2,0,0,16,0,2
黑龙江,2020-02-03,6,0,0,22,0,2
黑龙江,2020-02-04,2,0,0,24,0,2
黑龙江,2020-02-05,5,0,0,29,0,2
黑龙江,2020-02-06,5,0,0,34,0,2
黑龙江,2020-02-07,1,1,0,35,1,2
黑龙江,2020-02-08,0,0,1,35,1,3
黑龙江,2020-02-09,2,0,0,37,1,3
黑龙江,2020-02-10,2,2,1,39,3,4
黑龙江,2020-02-11,4,0,0,43,3,4
黑龙江,2020-02-12,2,0,0,45,3,4
黑龙江,2020-02-14,1,4,0,46,7,4
黑龙江,2020-02-15,0,5,0,46,12,4
黑龙江,2020-02-16,0,1,0,46,13,4
黑龙江,2020-02-17,0,1,0,46,14,4
黑龙江,2020-02-18,1,2,0,47,16,4
黑龙江,2020-02-19,0,2,0,47,18,4
黑龙江,2020-02-20,0,2,0,47,20,4
黑龙江,2020-02-21,0,6,0,47,26,4
黑龙江,2020-02-22,0,3,0,47,29,4
黑龙江,2020-02-25,0,6,0,47,35,4
黑龙江,2020-03-04,0,2,0,47,37,4
黑龙江,2020-03-08,0,1,0,47,38,4
黑龙江,2020-03-09,0,2,0,47,40,4
黑龙江,2020-03-12,0,1,0,47,41,4
黑龙江,2020-03-16,0,1,0,47,42,4
黑龙江,2020-03-17,0,1,0,47,43,4
四川,2020-01-23,1,0,0,1,0,0
四川,2020-01-24,1,0,0,2,0,0
四川,2020-01-27,1,0,0,3,0,0
四川,2020-01-29,1,0,0,4,0,0
四川,2020-01-30,1,0,0,5,0,0
四川,2020-02-03,0,1,0,5,1,0
四川,2020-02-06,0,1,0,5,2,0
四川,2020-02-07,1,0,0,6,2,0
四川,2020-02-08,2,0,0,8,2,0
四川,2020-02-09,2,0,0,10,2,0
四川,2020-02-12,0,2,0,10,4,0
四川,2020-02-15,2,0,0,12,4,0
四川,2020-02-16,5,0,0,17,4,0
四川,2020-02-17,0,5,0,17,9,0
四川,2020-02-19,0,1,0,17,10,0
四川,2020-02-26,0,3,0,17,13,0
四川,2020-02-27,0,2,0,17,15,0
四川,2020-03-10,0,2,0,17,17,0
山东,2020-01-23,1,0,0,1,0,0
山东,2020-01-25,1,0,0,2,0,0
山东,2020-01-26,1,0,0,3,0,0
山东,2020-01-28,2,0,0,5,0,0
山东,2020-01-29,2,0,0,7,0,0
山东,2020-01-30,1,0,0,8,0,0
山东,2020-01-31,1,0,0,9,0,0
山东,2020-02-01,1,0,0,10,0,0
山东,2020-02-02,3,0,0,13,0,0
山东,2020-02-04,3,0,0,16,0,0
山东,2020-02-05,5,0,0,21,0,0
山东,2020-02-06,6,0,0,27,0,0
山东,2020-02-07,2,0,0,29,0,0
山东,2020-02-08,5,1,0,34,1,0
山东,2020-02-09,3,0,0,37,1,0
山东,2020-02-10,1,0,0,38,1,0
山东,2020-02-11,0,3,0,38,4,0
山东,2020-02-12,0,1,0,38,5,0
山东,2020-02-13,3,1,0,41,6,0
山东,2020-02-14,1,1,0,42,7,0
山东,2020-02-15,1,2,0,43,9,0
山东,2020-02-16,1,1,0,44,10,0
山东,2020-02-17,0,1,0,44,11,0
山东,2020-02-18,0,3,0,44,14,0
山东,2020-02-19,0,1,0,44,15,0
山东,2020-02-20,0,2,0,44,17,0
山东,2020-02-22,0,1,0,44,18,0
山东,2020-02-23,0,4,0,44,22,0
山东,2020-02-25,0,2,0,44,24,0
山东,2020-02-28,0,5,0,44,29,0
山东,2020-03-01,0,1,0,44,30,0
山东,2020-03-02,0,1,0,44,31,0
山东,2020-03-04,0,2,0,44,33,0
山东,2020-03-05,0,1,0,44,34,0
山东,2020-03-06,0,6,0,44,40,0
山东,2020-03-08,0,4,0,44,44,0
新疆,2020-01-23,2,0,0,2,0,0
新疆,2020-01-24,1,0,0,3,0,0
新疆,2020-01-26,1,0,0,4,0,0
新疆,2020-01-27,1,0,0,5,0,0
新疆,2020-01-28,1,0,0,6,0,0
新疆,2020-01-29,1,0,0,7,0,0
新疆,2020-01-30,1,0,0,8,0,0
新疆,2020-02-02,2,0,0,10,0,0
新疆,2020-02-03,2,0,0,12,0,0
新疆,2020-02-05,3,0,0,15,0,0
新疆,2020-02-06,3,0,0,18,0,0
新疆,2020-02-07,1,0,0,19,0,0
新疆,2020-02-08,1,0,0,20,0,0
新疆,2020-02-11,0,2,0,20,2,0
新疆,2020-02-12,1,0,0,21,2,0
新疆,2020-02-13,2,0,0,23,2,0
新疆,2020-02-15,0,1,0,23,3,0
新疆,2020-02-16,0,1,0,23,4,0
新疆,2020-02-18,0,2,0,23,6,0
新疆,2020-02-19,0,2,0,23,8,0
新疆,2020-02-20,0,2,0,23,10,0
新疆,2020-02-23,0,3,0,23,13,0
新疆,2020-02-27,0,1,0,23,14,0
新疆,2020-02-28,0,2,0,23,16,0
新疆,2020-02-29,0,1,0,23,17,0
新疆,2020-03-01,0,2,0,23,19,0
新疆,2020-03-02,0,2,0,23,21,0
新疆,2020-03-03,0,1,0,23,22,0
新疆,2020-03-06,0,1,0,23,23,0
重庆,2020-01-23,1,0,0,1,0,0
重庆,2020-01-24,1,0,0,2,0,0
重庆,2020-01-25,1,0,0,3,0,0
重庆,2020-01-26,2,0,0,5,0,0
重庆,2020-01-30,4,0,0,9,0,0
重庆,2020-01-31,1,0,0,10,0,0
重庆,2020-02-01,1,0,0,11,0,0
重庆,2020-02-04,0,1,0,11,1,0
重庆,2020-02-08,1,0,0,12,1,0
重庆,2020-02-09,0,1,0,12,2,0
重庆,2020-02-11,1,2,0,13,4,0
重庆,2020-02-12,0,2,0,13,6,0
重庆,2020-02-13,0,1,0,13,7,0
重庆,2020-02-15,0,1,0,13,8,0
重庆,2020-02-17,0,1,0,13,9,0
重庆,2020-02-21,1,0,0,14,9,0
重庆,2020-02-24,0,1,0,14,10,0
重庆,2020-02-25,0,1,0,14,11,0
重庆,2020-02-26,0,1,0,14,12,0
重庆,2020-03-01,0,1,0,14,13,0
重庆,2020-03-04,0,1,0,14,14,0
江苏,2020-01-23,1,0,0,1,0,0
江苏,2020-01-25,1,0,0,2,0,0
江苏,2020-01-26,2,0,0,4,0,0
江苏,2020-01-27,2,0,0,6,0,0
江苏,2020-01-28,3,0,0,9,0,0
江苏,2020-01-29,1,0,0,10,0,0
江苏,2020-01-30,2,0,0,12,0,0
江苏,2020-01-31,1,0,0,13,0,0
江苏,2020-02-01,6,0,0,19,0,0
江苏,2020-02-02,4,0,0,23,0,0
江苏,2020-02-03,2,1,0,25,1,0
江苏,2020-02-04,1,0,0,26,1,0
江苏,2020-02-05,2,0,0,28,1,0
江苏,2020-02-06,3,0,0,31,1,0
江苏,2020-02-07,3,0,0,34,1,0
江苏,2020-02-08,4,2,0,38,3,0
江苏,2020-02-09,3,0,0,41,3,0
江苏,2020-02-10,4,1,0,45,4,0
江苏,2020-02-11,3,0,0,48,4,0
江苏,2020-02-12,1,4,0,49,8,0
江苏,2020-02-13,2,1,0,51,9,0
江苏,2020-02-14,1,6,0,52,15,0
江苏,2020-02-15,1,3,0,53,18,0
江苏,2020-02-16,2,1,0,55,19,0
江苏,2020-02-17,0,2,0,55,21,0
江苏,2020-02-18,0,6,0,55,27,0
江苏,2020-02-19,0,6,0,55,33,0
江苏,2020-02-20,0,3,0,55,36,0
江苏,2020-02-21,0,1,0,55,37,0
江苏,2020-02-22,0,2,0,55,39,0
江苏,2020-02-23,0,2,0,55,41,0
江苏,2020-02-25,0,1,0,55,42,0
江苏,2020-02-26,0,3,0,55,45,0
江苏,2020-02-27,0,2,0,55,47,0
江苏,2020-02-28,0,1,0,55,48,0
江苏,2020-02-29,0,1,0,55,49,0
江苏,2020-03-02,0,1,0,55,50,0
江苏,2020-03-04,0,2,0,55,52,0
江苏,2020-03-11,0,1,0,55,53,0
江苏,2020-03-12,0,1,0,55,54,0
湖北,2020-01-23,2,0,0,2,0,0
湖北,2020-01-24,8,0,0,10,0,0
湖北,2020-01-25,1,0,0,11,0,0
湖北,2020-01-26,1,0,0,12,0,0
湖北,2020-01-27,15,0,0,27,0,0
湖北,2020-01-28,5,0,0,32,0,0
湖北,2020-01-29,23,0,0,55,0,0
湖北,2020-01-30,35,0,1,90,0,1
湖北,2020-01-31,7,0,0,97,0,1
湖北,2020-02-01,43,0,2,140,0,3
湖北,2020-02-02,29,0,0,169,0,3
湖北,2020-02-03,19,0,0,188,0,3
湖北,2020-02-04,37,0,1,225,0,4
湖北,2020-02-05,40,0,1,265,0,5
湖北,2020-02-06,42,11,0,307,11,5
湖北,2020-02-07,52,3,0,359,14,5
湖北,2020-02-08,20,2,0,379,16,5
湖北,2020-02-09,37,0,2,416,16,7
湖北,2020-02-10,22,25,4,438,41,11
湖北,2020-02-11,22,2,2,460,43,13
湖北,2020-02-12,20,5,3,480,48,16
湖北,2020-02-13,20,10,1,500,58,17
湖北,2020-02-14,14,5,0,514,63,17
湖北,2020-02-15,9,24,0,523,87,17
湖北,2020-02-16,8,20,2,531,107,19
湖北,2020-02-17,13,14,0,544,121,19
湖北,2020-02-18,18,28,0,562,149,19
湖北,2020-02-19,5,35,0,567,184,19
湖北,2020-02-20,1,26,0,568,210,19
湖北,2020-02-21,3,21,0,571,231,19
湖北,2020-02-22,0,17,0,571,248,19
湖北,2020-02-23,2,20,0,573,268,19
湖北,2020-02-24,2,48,0,575,316,19
湖北,2020-02-25,0,21,0,575,337,19
湖北,2020-02-26,0,19,0,575,356,19
湖北,2020-02-27,0,32,0,575,388,19
湖北,2020-02-28,0,20,0,575,408,19
湖北,2020-02-29,0,30,0,575,438,19
湖北,2020-03-01,0,23,0,575,461,19
湖北,2020-03-02,0,6,1,575,467,20
湖北,2020-03-03,0,10,0,575,477,20
湖北,2020-03-04,0,4,0,575,481,20
湖北,2020-03-05,0,9,0,575,490,20
湖北,2020-03-06,0,7,1,575,497,21
湖北,2020-03-07,0,4,0,575,501,21
湖北,2020-03-08,0,5,0,575,506,21
湖北,2020-03-09,0,12,1,575,518,22
湖北,2020-03-10,0,2,0,575,520,22
湖北,2020-03-14,0,6,0,575,526,22
湖北,2020-03-15,0,3,0,575,529,22
湖北,2020-03-16,0,2,0,575,531,22
湖北,2020-03-17,0,4,0,575,535,22
湖北,2020-03-18,0,3,0,575,538,22
湖北,2020-03-19,0,4,0,575,542,22
湖北,2020-03-20,0,4,0,575,546,22
湖北,2020-03-21,0,1,0,575,547,22
湖北,2020-03-24,0,4,0,575,551,22
湖北,2020-03-27,0,1,0,575,552,22
湖北,2020-04-10,0,1,0,575,553,22
湖南,2020-01-23,1,0,0,1,0,0
湖南,2020-01-24,1,0,0,2,0,0
湖南,2020-01-25,1,0,0,3,0,0
湖南,2020-01-26,1,0,0,4,0,0
湖南,2020-01-27,2,0,0,6,0,0
湖南,2020-01-28,2,0,0,8,0,0
湖南,2020-01-29,1,0,0,9,0,0
湖南,2020-01-30,1,0,0,10,0,0
湖南,2020-01-31,3,0,0,13,0,0
湖南,2020-02-01,3,0,0,16,0,0
湖南,2020-02-02,3,3,0,19,3,0
湖南,2020-02-03,2,0,0,21,3,0
湖南,2020-02-04,2,1,0,23,4,0
湖南,2020-02-05,1,1,0,24,5,0
湖南,2020-02-06,1,2,0,25,7,0
湖南,2020-02-07,3,0,0,28,7,0
湖南,2020-02-08,0,3,0,28,10,0
湖南,2020-02-09,3,1,0,31,11,0
湖南,2020-02-10,1,0,0,32,11,0
湖南,2020-02-12,0,1,0,32,12,0
湖南,2020-02-13,2,0,0,34,12,0
湖南,2020-02-14,1,2,0,35,14,0
湖南,2020-02-16,0,1,0,35,15,0
湖南,2020-02-17,0,1,0,35,16,0
湖南,2020-02-18,0,1,0,35,17,0
湖南,2020-02-21,1,2,0,36,19,0
湖南,2020-02-22,0,2,0,36,21,0
湖南,2020-02-23,0,4,0,36,25,0
湖南,2020-02-24,0,1,0,36,26,0
湖南,2020-02-25,0,3,0,36,29,0
湖南,2020-02-27,0,4,0,36,33,0
湖南,2020-02-29,0,1,0,36,34,0
湖南,2020-03-02,0,1,0,36,35,0
湖南,2020-03-05,0,1,0,36,36,0
湖北,2020-01-23,22,0,0,22,0,0
湖北,2020-01-24,4,0,0,26,0,0
湖北,2020-01-25,29,0,0,55,0,0
湖北,2020-01-26,45,0,1,100,0,1
湖北,2020-01-27,73,0,0,173,0,1
湖北,2020-01-28,101,0,2,274,0,3
湖北,2020-01-29,125,0,3,399,0,6
湖北,2020-01-30,142,2,3,541,2,9
湖北,2020-01-31,87,0,3,628,2,12
湖北,2020-02-01,121,0,2,749,2,14
湖北,2020-02-02,169,0,0,918,2,14
湖北,2020-02-03,202,2,3,1120,4,17
湖北,2020-02-04,342,2,1,1462,6,18
湖北,2020-02-05,424,3,7,1886,9,25
湖北,2020-02-06,255,16,0,2141,25,25
湖北,2020-02-07,172,13,1,2313,38,26
湖北,2020-02-08,123,7,3,2436,45,29
湖北,2020-02-09,105,36,4,2541,81,33
湖北,2020-02-10,101,58,8,2642,139,41
湖北,2020-02-11,109,40,4,2751,179,45
湖北,2020-02-12,123,28,4,2874,207,49
湖北,2020-02-13,135,48,8,3009,255,57
湖北,2020-02-14,105,58,5,3114,313,62
湖北,2020-02-15,87,40,3,3201,353,65
湖北,2020-02-16,78,96,5,3279,449,70
湖北,2020-02-17,41,74,5,3320,523,75
湖北,2020-02-18,24,49,7,3344,572,82
湖北,2020-02-19,66,101,7,3410,673,89
湖北,2020-02-20,17,98,5,3427,771,94
湖北,2020-02-21,2,146,4,3429,917,98
湖北,2020-02-22,14,161,4,3443,1078,102
湖北,2020-02-23,22,99,6,3465,1177,108
湖北,2020-02-24,17,151,2,3482,1328,110
湖北,2020-02-25,19,60,3,3501,1388,113
湖北,2020-02-26,15,234,0,3516,1622,113
湖北,2020-02-27,1,173,1,3517,1795,114
湖北,2020-02-28,1,252,1,3518,2047,115
湖北,2020-02-29,0,168,3,3518,2215,118
湖北,2020-03-01,0,182,2,3518,2397,120
湖北,2020-03-02,0,163,0,3518,2560,120
湖北,2020-03-03,0,153,0,3518,2713,120
湖北,2020-03-04,0,108,1,3518,2821,121
湖北,2020-03-05,0,90,2,3518,2911,123
湖北,2020-03-06,0,61,0,3518,2972,123
湖北,2020-03-07,0,52,2,3518,3024,125
湖北,2020-03-08,0,33,1,3518,3057,126
湖北,2020-03-09,0,54,0,3518,3111,126
湖北,2020-03-10,0,38,0,3518,3149,126
湖北,2020-03-11,0,30,0,3518,3179,126
湖北,2020-03-12,0,25,0,3518,3204,126
湖北,2020-03-13,0,33,0,3518,3237,126
湖北,2020-03-14,0,16,0,3518,3253,126
湖北,2020-03-15,0,13,1,3518,3266,127
湖北,2020-03-16,0,12,0,3518,3278,127
湖北,2020-03-17,0,19,1,3518,3297,128
湖北,2020-03-18,0,24,0,3518,3321,128
湖北,2020-03-19,0,28,0,3518,3349,128
湖北,2020-03-20,0,11,0,3518,3360,128
湖北,2020-03-21,0,6,0,3518,3366,128
湖北,2020-03-22,0,3,0,3518,3369,128
湖北,2020-03-23,0,7,0,3518,3376,128
湖北,2020-03-24,0,4,0,3518,3380,128
湖北,2020-03-25,0,3,0,3518,3383,128
湖北,2020-03-26,0,3,0,3518,3386,128
湖北,2020-03-27,0,3,0,3518,3389,128
湖北,2020-04-05,0,0,1,3518,3389,129
江西,2020-01-23,1,0,0,1,0,0
江西,2020-01-26,2,0,0,3,0,0
江西,2020-01-28,8,1,0,11,1,0
江西,2020-01-30,17,1,0,28,2,0
江西,2020-01-31,12,0,0,40,2,0
江西,2020-02-01,3,1,0,43,3,0
江西,2020-02-02,7,0,0,50,3,0
江西,2020-02-03,9,0,0,59,3,0
江西,2020-02-04,10,1,0,69,4,0
江西,2020-02-05,9,1,0,78,5,0
江西,2020-02-06,9,0,0,87,5,0
江西,2020-02-07,8,3,0,95,8,0
江西,2020-02-08,5,5,0,100,13,0
江西,2020-02-09,5,5,0,105,18,0
江西,2020-02-10,5,4,0,110,22,0
江西,2020-02-11,7,4,0,117,26,0
江西,2020-02-12,4,2,0,121,28,0
江西,2020-02-13,3,3,0,124,31,0
江西,2020-02-14,3,3,0,127,34,0
江西,2020-02-15,2,3,0,129,37,0
江西,2020-02-16,0,7,0,129,44,0
江西,2020-02-17,0,2,0,129,46,0
江西,2020-02-18,0,12,0,129,58,0
江西,2020-02-19,1,10,0,130,68,0
江西,2020-02-20,0,12,0,130,80,0
江西,2020-02-21,0,7,0,130,87,0
江西,2020-02-22,0,8,0,130,95,0
江西,2020-02-23,0,8,0,130,103,0
江西,2020-02-24,0,6,0,130,109,0
江西,2020-02-25,0,2,0,130,111,0
江西,2020-02-26,0,4,0,130,115,0
江西,2020-02-27,0,3,0,130,118,0
江西,2020-02-28,0,2,0,130,120,0
江西,2020-03-01,0,1,0,130,121,0
江西,2020-03-02,0,1,0,130,122,0
江西,2020-03-03,0,1,0,130,123,0
江西,2020-03-06,0,3,0,130,126,0
江西,2020-03-07,0,1,0,130,127,0
江西,2020-03-08,0,3,0,130,130,0
河南,2020-01-23,1,0,0,1,0,0
河南,2020-01-24,5,0,0,6,0,0
河南,2020-01-25,16,0,0,22,0,0
河南,2020-01-26,1,0,0,23,0,0
河南,2020-01-27,6,0,0,29,0,0
河南,2020-01-28,3,0,0,32,0,0
河南,2020-01-29,10,0,0,42,0,0
河南,2020-01-30,7,0,0,49,0,0
河南,2020-01-31,21,0,0,70,0,0
河南,2020-02-01,18,0,0,88,0,0
河南,2020-02-02,11,4,0,99,4,0
河南,2020-02-03,13,0,0,112,4,0
河南,2020-02-04,26,1,0,138,5,0
河南,2020-02-05,26,0,0,164,5,0
河南,2020-02-06,12,0,0,176,5,0
河南,2020-02-07,16,0,0,192,5,0
河南,2020-02-08,13,4,0,205,9,0
河南,2020-02-09,15,0,0,220,9,0
河南,2020-02-10,8,6,0,228,15,0
河南,2020-02-11,3,4,0,231,19,0
河南,2020-02-12,9,11,0,240,30,0
河南,2020-02-13,3,11,1,243,41,1
河南,2020-02-14,9,6,0,252,47,1
河南,2020-02-15,9,4,0,261,51,1
河南,2020-02-16,1,10,0,262,61,1
河南,2020-02-17,4,26,0,266,87,1
河南,2020-02-18,2,12,0,268,99,1
河南,2020-02-19,1,32,0,269,131,1
河南,2020-02-20,1,16,0,270,147,1
河南,2020-02-21,3,5,0,273,152,1
河南,2020-02-22,1,10,0,274,162,1
河南,2020-02-23,0,7,0,274,169,1
河南,2020-02-24,0,17,0,274,186,1
河南,2020-02-25,0,11,0,274,197,1
河南,2020-02-26,0,8,0,274,205,1
河南,2020-02-27,0,12,0,274,217,1
河南,2020-02-28,0,19,0,274,236,1
河南,2020-02-29,0,3,0,274,239,1
河南,2020-03-01,0,1,0,274,240,1
河南,2020-03-02,0,5,0,274,245,1
重庆,2020-01-23,1,0,0,1,0,0
重庆,2020-02-01,0,1,0,1,1,0
四川,2020-01-23,1,0,0,1,0,0
四川,2020-01-27,1,0,0,2,0,0
四川,2020-01-30,1,0,0,3,0,0
四川,2020-01-31,2,0,0,5,0,0
四川,2020-02-04,1,0,0,6,0,0
四川,2020-02-07,0,1,0,6,1,0
四川,2020-02-09,0,1,0,6,2,0
四川,2020-02-12,1,0,0,7,2,0
四川,2020-02-19,0,1,0,7,3,0
四川,2020-02-20,0,1,0,7,4,0
四川,2020-02-24,0,1,0,7,5,0
四川,2020-02-25,0,1,0,7,6,0
四川,2020-03-11,0,1,0,7,7,0
四川,2020-06-15,1,0,0,8,7,0
陕西,2020-01-23,1,0,0,1,0,0
陕西,2020-01-26,1,0,0,2,0,0
陕西,2020-01-28,1,0,0,3,0,0
陕西,2020-01-30,4,0,0,7,0,0
陕西,2020-02-07,1,0,0,8,0,0
陕西,2020-02-10,0,2,0,8,2,0
陕西,2020-02-11,0,1,0,8,3,0
陕西,2020-02-12,0,3,0,8,6,0
陕西,2020-02-22,0,2,0,8,8,0
江苏,2020-01-23,1,0,0,1,0,0
江苏,2020-01-26,3,0,0,4,0,0
江苏,2020-01-27,1,0,0,5,0,0
江苏,2020-01-28,3,0,0,8,0,0
江苏,2020-01-31,5,0,0,13,0,0
江苏,2020-02-02,1,0,0,14,0,0
江苏,2020-02-03,1,0,0,15,0,0
江苏,2020-02-06,2,0,0,17,0,0
江苏,2020-02-07,0,2,0,17,2,0
江苏,2020-02-08,1,0,0,18,2,0
江苏,2020-02-10,0,1,0,18,3,0
江苏,2020-02-11,0,3,0,18,6,0
江苏,2020-02-12,2,0,0,20,6,0
江苏,2020-02-14,1,0,0,21,6,0
江苏,2020-02-15,1,1,0,22,7,0
江苏,2020-02-16,1,1,0,23,8,0
江苏,2020-02-17,0,1,0,23,9,0
江苏,2020-02-18,0,2,0,23,11,0
江苏,2020-02-20,0,2,0,23,13,0
江苏,2020-02-21,0,2,0,23,15,0
江苏,2020-02-22,0,2,0,23,17,0
江苏,2020-02-28,0,2,0,23,19,0
江苏,2020-02-29,0,4,0,23,23,0
广东,2020-01-23,3,0,0,3,0,0
广东,2020-01-24,2,0,0,5,0,0
广东,2020-01-25,1,0,0,6,0,0
广东,2020-01-26,2,0,0,8,0,0
广东,2020-01-28,2,0,0,10,0,0
广东,2020-02-03,2,0,0,12,0,0
广东,2020-02-05,1,0,0,13,0,0
广东,2020-02-07,0,1,0,13,1,0
广东,2020-02-12,0,4,0,13,5,0
广东,2020-02-15,0,2,0,13,7,0
广东,2020-02-17,0,2,0,13,9,0
广东,2020-02-20,0,1,0,13,10,0
广东,2020-02-23,1,0,0,14,10,0
广东,2020-02-28,0,1,0,14,11,0
广东,2020-03-06,0,3,0,14,14,0
湖北,2020-01-23,1,0,1,1,0,1
湖北,2020-01-25,19,0,0,20,0,1
湖北,2020-01-26,11,0,0,31,0,1
湖北,2020-01-27,20,0,0,51,0,1
湖北,2020-01-28,12,0,0,63,0,1
湖北,2020-01-29,54,0,0,117,0,1
湖北,2020-01-30,50,0,0,167,0,1
湖北,2020-01-31,109,0,0,276,0,1
湖北,2020-02-01,77,0,0,353,0,1
湖北,2020-02-02,39,1,0,392,1,1
湖北,2020-02-03,60,1,2,452,2,3
湖北,2020-02-04,44,7,1,496,9,4
湖北,2020-02-05,67,0,2,563,9,6
湖北,2020-02-06,47,2,1,610,11,7
湖北,2020-02-07,23,13,1,633,24,8
湖北,2020-02-08,71,12,0,704,36,8
湖北,2020-02-09,45,7,0,749,43,8
湖北,2020-02-10,23,9,0,772,52,8
湖北,2020-02-11,12,10,0,784,62,8
湖北,2020-02-12,26,10,3,810,72,11
湖北,2020-02-13,61,9,2,871,81,13
湖北,2020-02-14,24,11,2,895,92,15
湖北,2020-02-15,0,48,6,895,140,21
湖北,2020-02-16,0,16,4,895,156,25
湖北,2020-02-17,9,30,0,904,186,25
湖北,2020-02-18,3,22,1,907,208,26
湖北,2020-02-19,3,23,2,910,231,28
湖北,2020-02-20,4,19,1,914,250,29
湖北,2020-02-21,0,23,1,914,273,30
湖北,2020-02-22,3,16,0,917,289,30
湖北,2020-02-23,7,15,0,924,304,30
湖北,2020-02-24,2,24,0,926,328,30
湖北,2020-02-25,1,34,1,927,362,31
湖北,2020-02-26,2,34,0,929,396,31
湖北,2020-02-27,2,33,1,931,429,32
湖北,2020-02-28,0,33,0,931,462,32
湖北,2020-02-29,0,44,0,931,506,32
湖北,2020-03-01,0,29,0,931,535,32
湖北,2020-03-02,0,48,1,931,583,33
湖北,2020-03-03,0,25,0,931,608,33
湖北,2020-03-04,0,30,1,931,638,34
湖北,2020-03-05,0,46,0,931,684,34
湖北,2020-03-06,0,23,0,931,707,34
湖北,2020-03-07,0,20,1,931,727,35
湖北,2020-03-08,0,26,0,931,753,35
湖北,2020-03-09,0,19,0,931,772,35
湖北,2020-03-10,0,28,1,931,800,36
湖北,2020-03-11,0,34,0,931,834,36
湖北,2020-03-12,0,13,0,931,847,36
湖北,2020-03-13,0,11,0,931,858,36
湖北,2020-03-14,0,6,0,931,864,36
湖北,2020-03-15,0,4,0,931,868,36
湖北,2020-03-16,0,5,0,931,873,36
湖北,2020-03-17,0,8,0,931,881,36
湖北,2020-03-18,0,1,0,931,882,36
湖北,2020-03-19,0,4,0,931,886,36
湖北,2020-03-20,0,5,0,931,891,36
湖北,2020-03-22,0,1,0,931,892,36
湖北,2020-03-24,0,1,0,931,893,36
湖北,2020-03-26,0,1,0,931,894,36
湖北,2020-04-14,0,0,1,931,894,37
重庆,2020-01-23,2,0,0,2,0,0
重庆,2020-01-25,2,0,0,4,0,0
重庆,2020-01-26,1,0,0,5,0,0
重庆,2020-01-27,1,0,0,6,0,0
重庆,2020-01-29,1,0,0,7,0,0
重庆,2020-01-30,3,0,0,10,0,0
重庆,2020-01-31,1,0,0,11,0,0
重庆,2020-02-01,1,0,0,12,0,0
重庆,2020-02-06,0,2,0,12,2,0
重庆,2020-02-09,1,0,0,13,2,0
重庆,2020-02-10,2,0,0,15,2,0
重庆,2020-02-12,0,1,0,15,3,0
重庆,2020-02-13,0,1,0,15,4,0
重庆,2020-02-14,0,1,0,15,5,0
重庆,2020-02-16,0,2,0,15,7,0
重庆,2020-02-17,1,0,0,16,7,0
重庆,2020-02-18,0,1,0,16,8,0
重庆,2020-02-19,0,1,0,16,9,0
重庆,2020-02-20,1,0,0,17,9,0
重庆,2020-02-21,0,1,0,17,10,0
重庆,2020-02-25,0,1,0,17,11,0
重庆,2020-02-27,0,2,0,17,13,0
重庆,2020-02-28,0,2,0,17,15,0
重庆,2020-03-01,0,1,0,17,16,0
重庆,2020-03-07,0,1,0,17,17,0
湖南,2020-01-23,3,0,0,3,0,0
湖南,2020-01-24,2,0,0,5,0,0
湖南,2020-01-25,1,0,0,6,0,0
湖南,2020-01-26,1,0,0,7,0,0
湖南,2020-01-27,10,0,0,17,0,0
湖南,2020-01-28,9,0,0,26,0,0
湖南,2020-01-29,3,0,0,29,0,0
湖南,2020-01-30,8,0,0,37,0,0
湖南,2020-01-31,8,0,0,45,0,0
湖南,2020-02-01,8,0,0,53,0,0
湖南,2020-02-02,17,0,0,70,0,0
湖南,2020-02-03,13,0,0,83,0,0
湖南,2020-02-04,6,0,0,89,0,0
湖南,2020-02-05,4,2,0,93,2,0
湖南,2020-02-06,14,2,0,107,4,0
湖南,2020-02-07,4,2,0,111,6,0
湖南,2020-02-08,4,4,1,115,10,1
湖南,2020-02-09,9,7,0,124,17,1
湖南,2020-02-10,10,4,0,134,21,1
湖南,2020-02-11,12,3,0,146,24,1
湖南,2020-02-12,2,18,0,148,42,1
湖南,2020-02-13,1,2,0,149,44,1
湖南,2020-02-14,4,4,0,153,48,1
湖南,2020-02-15,1,3,0,154,51,1
湖南,2020-02-16,0,3,0,154,54,1
湖南,2020-02-17,1,9,0,155,63,1
湖南,2020-02-18,0,1,0,155,64,1
湖南,2020-02-19,1,0,0,156,64,1
湖南,2020-02-20,0,8,0,156,72,1
湖南,2020-02-21,0,5,0,156,77,1
湖南,2020-02-22,0,10,0,156,87,1
湖南,2020-02-23,0,4,0,156,91,1
湖南,2020-02-24,0,7,0,156,98,1
湖南,2020-02-25,0,8,0,156,106,1
湖南,2020-02-26,0,1,0,156,107,1
湖南,2020-02-27,0,6,0,156,113,1
湖南,2020-02-28,0,1,0,156,114,1
湖南,2020-02-29,0,1,0,156,115,1
湖南,2020-03-01,0,4,0,156,119,1
湖南,2020-03-02,0,5,0,156,124,1
湖南,2020-03-03,0,6,0,156,130,1
湖南,2020-03-04,0,7,0,156,137,1
湖南,2020-03-05,0,2,0,156,139,1
湖南,2020-03-06,0,6,0,156,145,1
湖南,2020-03-07,0,1,0,156,146,1
湖南,2020-03-08,0,5,0,156,151,1
湖南,2020-03-10,0,2,0,156,153,1
湖南,2020-03-14,0,2,0,156,155,1
重庆,2020-01-23,1,0,0,1,0,0
重庆,2020-01-24,1,0,0,2,0,0
重庆,2020-01-25,2,0,0,4,0,0
重庆,2020-01-26,4,0,0,8,0,0
重庆,2020-01-27,2,0,0,10,0,0
重庆,2020-01-28,1,0,0,11,0,0
重庆,2020-01-29,1,0,0,12,0,0
重庆,2020-01-30,3,0,0,15,0,0
重庆,2020-01-31,2,0,0,17,0,0
重庆,2020-02-01,1,0,0,18,0,0
重庆,2020-02-02,0,1,0,18,1,0
重庆,2020-02-04,0,1,0,18,2,0
重庆,2020-02-05,1,0,0,19,2,0
重庆,2020-02-06,0,1,0,19,3,0
重庆,2020-02-07,1,2,0,20,5,0
重庆,2020-02-08,0,2,0,20,7,0
重庆,2020-02-09,0,2,0,20,9,0
重庆,2020-02-10,1,1,0,21,10,0
重庆,2020-02-12,0,1,0,21,11,0
重庆,2020-02-13,1,1,0,22,12,0
重庆,2020-02-14,1,1,0,23,13,0
重庆,2020-02-15,0,3,0,23,16,0
重庆,2020-02-16,1,0,0,24,16,0
重庆,2020-02-17,1,0,0,25,16,0
重庆,2020-02-18,0,1,0,25,17,0
重庆,2020-02-20,0,2,0,25,19,0
重庆,2020-02-23,0,2,0,25,21,0
重庆,2020-02-28,0,1,0,25,22,0
重庆,2020-03-02,0,1,0,25,23,0
重庆,2020-03-03,0,1,0,25,24,0
重庆,2020-03-09,0,1,0,25,25,0
宁夏,2020-01-23,1,0,0,1,0,0
宁夏,2020-01-30,1,0,0,2,0,0
宁夏,2020-02-03,1,0,0,3,0,0
宁夏,2020-02-08,0,2,0,3,2,0
宁夏,2020-02-15,0,1,0,3,3,0
重庆,2020-01-23,1,0,0,1,0,0
重庆,2020-01-24,2,0,0,3,0,0
重庆,2020-01-25,2,0,0,5,0,0
重庆,2020-01-26,1,0,0,6,0,0
重庆,2020-01-27,3,0,0,9,0,0
重庆,2020-01-28,2,0,0,11,0,0
重庆,2020-01-30,1,0,0,12,0,0
重庆,2020-02-02,3,0,0,15,0,0
重庆,2020-02-04,0,1,0,15,1,0
重庆,2020-02-06,1,0,0,16,1,0
重庆,2020-02-08,0,2,0,16,3,0
重庆,2020-02-09,2,0,0,18,3,0
重庆,2020-02-10,1,3,0,19,6,0
重庆,2020-02-12,0,1,0,19,7,0
重庆,2020-02-14,0,2,0,19,9,0
重庆,2020-02-15,1,0,0,20,9,0
重庆,2020-02-16,0,1,0,20,10,0
重庆,2020-02-17,0,1,0,20,11,0
重庆,2020-02-18,0,1,0,20,12,0
重庆,2020-02-19,0,1,0,20,13,0
重庆,2020-02-20,0,5,0,20,18,0
重庆,2020-02-22,1,0,0,21,18,0
重庆,2020-03-03,0,1,0,21,19,0
重庆,2020-03-04,0,1,0,21,20,0
重庆,2020-03-06,0,1,0,21,21,0
河南,2020-01-23,1,0,0,1,0,0
河南,2020-01-24,3,0,0,4,0,0
河南,2020-01-25,1,0,0,5,0,0
河南,2020-01-26,6,0,0,11,0,0
河南,2020-01-27,4,0,0,15,0,0
河南,2020-01-28,4,0,0,19,0,0
河南,2020-01-29,6,0,0,25,0,0
河南,2020-01-30,11,0,0,36,0,0
河南,2020-01-31,2,0,0,38,0,0
河南,2020-02-01,2,0,0,40,0,0
河南,2020-02-02,7,1,0,47,1,0
河南,2020-02-03,5,0,0,52,1,0
河南,2020-02-04,4,0,0,56,1,0
河南,2020-02-05,3,0,0,59,1,0
河南,2020-02-06,1,0,0,60,1,0
河南,2020-02-07,2,0,0,62,1,0
河南,2020-02-09,3,0,0,65,1,0
河南,2020-02-11,1,0,0,66,1,0
河南,2020-02-12,2,0,0,68,1,0
河南,2020-02-13,1,0,0,69,1,0
河南,2020-02-14,1,0,0,70,1,0
河南,2020-02-15,1,0,0,71,1,0
河南,2020-02-16,4,0,0,75,1,0
河南,2020-02-17,1,0,0,76,1,0
湖南,2020-01-23,1,0,0,1,0,0
湖南,2020-01-25,2,0,0,3,0,0
湖南,2020-01-26,2,0,0,5,0,0
湖南,2020-01-27,2,0,0,7,0,0
湖南,2020-01-28,6,0,0,13,0,0
湖南,2020-01-29,5,0,0,18,0,0
湖南,2020-01-30,1,0,0,19,0,0
湖南,2020-01-31,3,0,0,22,0,0
湖南,2020-02-01,3,0,0,25,0,0
湖南,2020-02-02,1,1,0,26,1,0
湖南,2020-02-03,8,0,0,34,1,0
湖南,2020-02-04,4,1,0,38,2,0
湖南,2020-02-05,3,0,0,41,2,0
湖南,2020-02-06,5,5,0,46,7,0
湖南,2020-02-07,2,1,0,48,8,0
湖南,2020-02-08,10,1,0,58,9,0
湖南,2020-02-09,3,1,0,61,10,0
湖南,2020-02-10,7,1,0,68,11,0
湖南,2020-02-11,3,1,0,71,12,0
湖南,2020-02-12,4,2,0,75,14,0
湖南,2020-02-13,2,7,0,77,21,0
湖南,2020-02-14,1,2,0,78,23,0
湖南,2020-02-15,0,6,0,78,29,0
湖南,2020-02-16,0,4,0,78,33,0
湖南,2020-02-17,0,2,0,78,35,0
湖南,2020-02-18,0,2,0,78,37,0
湖南,2020-02-19,0,3,0,78,40,0
湖南,2020-02-20,0,6,0,78,46,0
湖南,2020-02-21,1,1,0,79,47,0
湖南,2020-02-22,1,0,0,80,47,0
湖南,2020-02-23,0,3,0,80,50,0
湖南,2020-02-24,0,2,0,80,52,0
湖南,2020-02-25,0,2,0,80,54,0
湖南,2020-02-26,0,2,0,80,56,0
湖南,2020-02-28,0,6,0,80,62,0
湖南,2020-03-01,0,7,0,80,69,0
湖南,2020-03-03,0,1,0,80,70,0
湖南,2020-03-04,0,3,0,80,73,0
湖南,2020-03-06,0,1,0,80,74,0
湖南,2020-03-08,0,2,0,80,76,0
湖南,2020-03-09,0,1,0,80,77,0
湖南,2020-03-12,0,1,0,80,78,0
湖南,2020-03-13,0,1,0,80,79,0
湖南,2020-03-14,0,1,0,80,80,0
河北,2020-01-24,1,0,0,1,0,0
河北,2020-01-25,2,0,0,3,0,0
河北,2020-01-28,3,0,0,6,0,0
河北,2020-01-29,1,0,0,7,0,0
河北,2020-01-30,4,0,0,11,0,0
河北,2020-02-01,2,2,0,13,2,0
河北,2020-02-04,4,0,0,17,2,0
河北,2020-02-05,0,2,0,17,4,0
河北,2020-02-06,1,0,0,18,4,0
河北,2020-02-07,0,4,0,18,8,0
河北,2020-02-08,3,0,0,21,8,0
河北,2020-02-09,5,0,0,26,8,0
河北,2020-02-10,4,1,0,30,9,0
河北,2020-02-11,1,0,0,31,9,0
河北,2020-02-12,0,2,0,31,11,0
河北,2020-02-14,1,6,0,32,17,0
河北,2020-02-15,0,2,0,32,19,0
河北,2020-02-16,0,2,0,32,21,0
河北,2020-02-17,0,5,0,32,26,0
河北,2020-02-18,0,1,0,32,27,0
河北,2020-02-21,0,2,0,32,29,0
河北,2020-02-24,0,3,0,32,32,0
河北,2020-06-15,4,0,0,36,32,0
河北,2020-06-16,1,0,0,37,32,0
河北,2020-06-17,2,0,0,39,32,0
河北,2020-06-18,2,0,0,41,32,0
河北,2020-06-19,1,0,0,42,32,0
河北,2020-06-20,1,0,0,43,32,0
河北,2020-06-21,1,0,0,44,32,0
河北,2020-06-24,1,0,0,45,32,0
河北,2020-06-25,0,1,0,45,33,0
河北,2020-06-26,3,2,0,48,35,0
河北,2020-06-27,0,3,0,48,38,0
河北,2020-06-28,0,5,0,48,43,0
河北,2020-06-29,0,3,0,48,46,0
河北,2020-06-30,0,2,0,48,48,0
辽宁,2020-01-24,1,0,0,1,0,0
辽宁,2020-01-26,1,0,0,2,0,0
辽宁,2020-01-29,1,0,0,3,0,0
辽宁,2020-02-13,0,1,0,3,1,0
辽宁,2020-02-18,0,2,0,3,3,0
重庆,2020-01-24,2,0,0,2,0,0
重庆,2020-01-26,1,0,0,3,0,0
重庆,2020-01-28,1,0,0,4,0,0
重庆,2020-01-30,2,0,0,6,0,0
重庆,2020-01-31,2,0,0,8,0,0
重庆,2020-02-10,0,1,0,8,1,0
重庆,2020-02-12,0,1,0,8,2,0
重庆,2020-02-13,0,1,0,8,3,0
重庆,2020-02-14,0,1,0,8,4,0
重庆,2020-02-16,1,1,0,9,5,0
重庆,2020-02-17,0,1,0,9,6,0
重庆,2020-02-18,0,1,0,9,7,0
重庆,2020-02-25,0,1,0,9,8,0
重庆,2020-02-28,0,1,0,9,9,0
天津,2020-01-24,1,0,0,1,0,0
天津,2020-01-30,1,0,0,2,0,0
天津,2020-02-06,1,0,0,3,0,0
天津,2020-02-16,0,1,0,3,1,0
天津,2020-02-21,0,1,0,3,2,0
天津,2020-02-24,0,1,0,3,3,0
湖南,2020-01-24,3,0,0,3,0,0
湖南,2020-01-25,4,0,0,7,0,0
湖南,2020-01-26,5,0,0,12,0,0
湖南,2020-01-27,7,0,0,19,0,0
湖南,2020-01-28,7,0,0,26,0,0
湖南,2020-01-29,4,0,0,30,0,0
湖南,2020-01-30,7,0,0,37,0,0
湖南,2020-01-31,2,0,0,39,0,0
湖南,2020-02-01,3,0,0,42,0,0
湖南,2020-02-02,3,0,0,45,0,0
湖南,2020-02-03,5,0,0,50,0,0
湖南,2020-02-04,6,3,0,56,3,0
湖南,2020-02-05,6,0,0,62,3,0
湖南,2020-02-06,2,11,0,64,14,0
湖南,2020-02-07,2,0,0,66,14,0
湖南,2020-02-08,0,1,0,66,15,0
湖南,2020-02-09,6,0,0,72,15,0
湖南,2020-02-10,1,0,0,73,15,0
湖南,2020-02-11,2,3,0,75,18,0
湖南,2020-02-12,2,6,0,77,24,0
湖南,2020-02-13,1,2,0,78,26,0
湖南,2020-02-14,0,1,0,78,27,0
湖南,2020-02-15,1,1,0,79,28,0
湖南,2020-02-16,0,3,0,79,31,0
湖南,2020-02-17,0,3,0,79,34,0
湖南,2020-02-18,0,9,0,79,43,0
湖南,2020-02-19,0,6,0,79,49,0
湖南,2020-02-20,1,3,0,80,52,0
湖南,2020-02-21,0,6,0,80,58,0
湖南,2020-02-22,2,2,0,82,60,0
湖南,2020-02-23,0,1,0,82,61,0
湖南,2020-02-24,0,1,0,82,62,0
湖南,2020-02-25,0,4,0,82,66,0
湖南,2020-02-26,0,1,0,82,67,0
湖南,2020-02-27,0,2,0,82,69,0
湖南,2020-02-28,0,3,0,82,72,0
湖南,2020-03-02,0,2,0,82,74,0
湖南,2020-03-03,0,6,0,82,80,0
湖南,2020-03-06,0,2,0,82,82,0
江苏,2020-01-24,5,0,0,5,0,0
江苏,2020-01-26,1,0,0,6,0,0
江苏,2020-01-27,2,0,0,8,0,0
江苏,2020-01-29,2,0,0,10,0,0
江苏,2020-01-30,3,0,0,13,0,0
江苏,2020-01-31,1,0,0,14,0,0
江苏,2020-02-01,1,0,0,15,0,0
江苏,2020-02-03,4,0,0,19,0,0
江苏,2020-02-04,5,2,0,24,2,0
江苏,2020-02-05,3,0,0,27,2,0
江苏,2020-02-06,2,3,0,29,5,0
江苏,2020-02-07,2,0,0,31,5,0
江苏,2020-02-09,0,1,0,31,6,0
江苏,2020-02-11,5,0,0,36,6,0
江苏,2020-02-12,2,5,0,38,11,0
江苏,2020-02-13,5,0,0,43,11,0
江苏,2020-02-15,3,0,0,46,11,0
江苏,2020-02-16,3,9,0,49,20,0
江苏,2020-02-17,1,0,0,50,20,0
江苏,2020-02-18,1,7,0,51,27,0
江苏,2020-02-20,0,2,0,51,29,0
江苏,2020-02-21,0,7,0,51,36,0
江苏,2020-02-24,0,5,0,51,41,0
江苏,2020-02-26,0,7,0,51,48,0
江苏,2020-03-02,0,2,0,51,50,0
江苏,2020-03-07,0,1,0,51,51,0
河北,2020-01-24,1,0,0,1,0,0
河北,2020-01-29,1,0,0,2,0,0
河北,2020-02-03,1,0,0,3,0,0
河北,2020-02-04,1,0,0,4,0,0
河北,2020-02-05,1,0,0,5,0,0
河北,2020-02-06,1,0,0,6,0,0
河北,2020-02-07,1,0,0,7,0,0
河北,2020-02-09,0,1,0,7,1,0
河北,2020-02-14,0,1,0,7,2,0
河北,2020-02-16,0,2,0,7,4,0
河北,2020-02-20,0,1,0,7,5,0
河北,2020-02-21,0,1,0,7,6,0
河北,2020-02-23,0,1,0,7,7,0
重庆,2020-01-24,1,0,0,1,0,0
重庆,2020-02-03,1,0,0,2,0,0
重庆,2020-02-06,0,1,0,2,1,0
重庆,2020-02-13,0,1,0,2,2,0
山西,2020-01-24,1,0,0,1,0,0
山西,2020-01-28,2,0,0,3,0,0
山西,2020-01-29,1,0,0,4,0,0
山西,2020-01-30,1,0,0,5,0,0
山西,2020-01-31,1,0,0,6,0,0
山西,2020-02-01,2,0,0,8,0,0
山西,2020-02-02,1,0,0,9,0,0
山西,2020-02-07,1,3,0,10,3,0
山西,2020-02-08,1,0,0,11,3,0
山西,2020-02-12,1,1,0,12,4,0
山西,2020-02-17,0,1,0,12,5,0
山西,2020-02-18,0,1,0,12,6,0
山西,2020-02-23,0,2,0,12,8,0
山西,2020-03-02,0,1,0,12,9,0
山西,2020-03-05,0,2,0,12,11,0
山西,2020-03-12,0,1,0,12,12,0
海南,2020-01-24,3,0,0,3,0,0
海南,2020-01-26,1,0,0,4,0,0
海南,2020-01-27,1,0,0,5,0,0
海南,2020-01-31,1,0,0,6,0,0
海南,2020-02-02,1,0,0,7,0,0
海南,2020-02-03,1,0,0,8,0,0
海南,2020-02-05,2,0,0,10,0,0
海南,2020-02-06,1,0,0,11,0,0
海南,2020-02-08,0,1,0,11,1,0
海南,2020-02-12,4,1,0,15,2,0
海南,2020-02-16,0,5,0,15,7,0
海南,2020-02-17,0,1,0,15,8,0
海南,2020-02-18,0,1,0,15,9,0
海南,2020-02-19,0,2,0,15,11,0
海南,2020-02-22,0,1,0,15,12,0
海南,2020-02-23,0,0,1,15,12,1
海南,2020-03-11,0,1,0,15,13,1
海南,2020-03-16,0,1,0,15,14,1
山东,2020-01-24,1,0,0,1,0,0
山东,2020-01-25,2,0,0,3,0,0
山东,2020-01-26,3,0,0,6,0,0
山东,2020-01-27,2,0,0,8,0,0
山东,2020-01-28,3,0,0,11,0,0
山东,2020-01-30,5,1,0,16,1,0
山东,2020-01-31,1,0,0,17,1,0
山东,2020-02-01,2,0,0,19,1,0
山东,2020-02-05,7,0,0,26,1,0
山东,2020-02-06,1,1,0,27,2,0
山东,2020-02-07,1,0,0,28,2,0
山东,2020-02-08,2,2,0,30,4,0
山东,2020-02-09,2,0,0,32,4,0
山东,2020-02-10,0,2,0,32,6,0
山东,2020-02-11,1,0,0,33,6,0
山东,2020-02-12,2,0,1,35,6,1
山东,2020-02-14,1,1,0,36,7,1
山东,2020-02-15,1,0,0,37,7,1
山东,2020-02-17,0,2,0,37,9,1
山东,2020-02-19,0,0,1,37,9,2
山东,2020-02-20,0,2,0,37,11,2
山东,2020-02-22,0,1,0,37,12,2
山东,2020-02-24,0,3,0,37,15,2
山东,2020-02-28,0,2,0,37,17,2
山东,2020-02-29,0,1,0,37,18,2
山东,2020-03-03,0,3,0,37,21,2
山东,2020-03-05,0,1,0,37,22,2
山东,2020-03-06,0,2,0,37,24,2
山东,2020-03-07,0,5,0,37,29,2
山东,2020-03-08,0,2,0,37,31,2
山东,2020-03-09,0,1,0,37,32,2
山东,2020-03-11,0,1,0,37,33,2
山东,2020-03-16,0,2,0,37,35,2
广东,2020-01-24,1,0,0,1,0,0
广东,2020-01-25,1,0,0,2,0,0
广东,2020-01-28,5,0,0,7,0,0
广东,2020-01-30,9,0,0,16,0,0
广东,2020-01-31,5,0,0,21,0,0
广东,2020-02-01,6,0,0,27,0,0
广东,2020-02-02,4,0,0,31,0,0
广东,2020-02-03,6,0,0,37,0,0
广东,2020-02-04,7,0,0,44,0,0
广东,2020-02-05,3,1,0,47,1,0
广东,2020-02-06,6,0,0,53,1,0
广东,2020-02-07,3,0,0,56,1,0
广东,2020-02-08,2,0,0,58,1,0
广东,2020-02-09,2,2,0,60,3,0
广东,2020-02-10,2,1,0,62,4,0
广东,2020-02-11,5,3,0,67,7,0
广东,2020-02-12,3,0,1,70,7,1
广东,2020-02-13,3,0,0,73,7,1
广东,2020-02-14,8,3,0,81,10,1
广东,2020-02-15,8,2,0,89,12,1
广东,2020-02-16,0,3,0,89,15,1
广东,2020-02-17,2,4,0,91,19,1
广东,2020-02-18,0,5,0,91,24,1
广东,2020-02-19,1,2,0,92,26,1
广东,2020-02-20,1,1,0,93,27,1
广东,2020-02-22,1,0,0,94,27,1
广东,2020-02-23,2,5,0,96,32,1
广东,2020-02-24,1,4,0,97,36,1
广东,2020-02-25,0,4,0,97,40,1
广东,2020-02-27,1,3,0,98,43,1
广东,2020-02-28,1,4,0,99,47,1
广东,2020-02-29,0,7,0,99,54,1
广东,2020-03-01,0,3,0,99,57,1
广东,2020-03-02,0,6,0,99,63,1
广东,2020-03-03,0,11,0,99,74,1
广东,2020-03-04,0,8,0,99,82,1
广东,2020-03-05,0,6,0,99,88,1
广东,2020-03-10,0,8,0,99,96,1
广东,2020-03-14,0,1,0,99,97,1
广东,2020-03-29,0,1,0,99,98,1
湖北,2020-01-24,1,0,0,1,0,0
湖北,2020-01-26,19,0,0,20,0,0
湖北,2020-01-27,37,0,0,57,0,0
湖北,2020-01-28,27,0,1,84,0,1
湖北,2020-01-29,39,0,1,123,0,2
湖北,2020-01-30,66,0,4,189,0,6
湖北,2020-01-31,38,0,3,227,0,9
湖北,2020-02-01,51,0,4,278,0,13
湖北,2020-02-02,28,2,2,306,2,15
湖北,2020-02-03,26,2,3,332,4,18
湖北,2020-02-04,50,2,0,382,6,18
湖北,2020-02-05,41,2,0,423,8,18
湖北,2020-02-06,48,1,0,471,9,18
湖北,2020-02-07,98,2,2,569,11,20
湖北,2020-02-08,67,31,1,636,42,21
湖北,2020-02-09,89,6,3,725,48,24
湖北,2020-02-10,65,13,2,790,61,26
湖北,2020-02-11,71,11,2,861,72,28
湖北,2020-02-12,204,23,2,1065,95,30
湖北,2020-02-13,60,21,2,1125,116,32
湖北,2020-02-14,67,83,1,1192,199,33
湖北,2020-02-15,38,23,1,1230,222,34
湖北,2020-02-16,44,22,1,1274,244,35
湖北,2020-02-17,65,21,1,1339,265,36
湖北,2020-02-18,4,36,1,1343,301,37
湖北,2020-02-19,25,49,1,1368,350,38
湖北,2020-02-20,5,25,1,1373,375,39
湖北,2020-02-21,2,11,0,1375,386,39
湖北,2020-02-22,4,31,1,1379,417,40
湖北,2020-02-23,4,48,0,1383,465,40
湖北,2020-02-24,2,31,1,1385,496,41
湖北,2020-02-25,2,47,0,1387,543,41
湖北,2020-02-26,2,68,1,1389,611,42
湖北,2020-02-27,0,74,1,1389,685,43
湖北,2020-02-28,1,62,1,1390,747,44
湖北,2020-02-29,1,37,3,1391,784,47
湖北,2020-03-01,0,30,1,1391,814,48
湖北,2020-03-02,0,26,0,1391,840,48
湖北,2020-03-03,1,40,1,1392,880,49
湖北,2020-03-04,2,32,3,1394,912,52
湖北,2020-03-05,0,18,1,1394,930,53
湖北,2020-03-06,0,26,1,1394,956,54
湖北,2020-03-07,0,32,0,1394,988,54
湖北,2020-03-08,0,42,0,1394,1030,54
湖北,2020-03-09,0,49,0,1394,1079,54
湖北,2020-03-10,0,48,0,1394,1127,54
湖北,2020-03-11,0,34,1,1394,1161,55
湖北,2020-03-12,0,23,0,1394,1184,55
湖北,2020-03-13,0,28,2,1394,1212,57
湖北,2020-03-14,0,60,0,1394,1272,57
湖北,2020-03-15,0,3,0,1394,1275,57
湖北,2020-03-16,0,5,0,1394,1280,57
湖北,2020-03-17,0,10,0,1394,1290,57
湖北,2020-03-18,0,8,1,1394,1298,58
湖北,2020-03-19,0,5,0,1394,1303,58
湖北,2020-03-20,0,12,0,1394,1315,58
湖北,2020-03-21,0,4,1,1394,1319,59
湖北,2020-03-22,0,4,0,1394,1323,59
湖北,2020-03-23,0,4,0,1394,1327,59
湖北,2020-03-24,0,1,0,1394,1328,59
湖北,2020-03-25,0,2,0,1394,1330,59
湖北,2020-03-26,0,2,0,1394,1332,59
湖北,2020-03-29,0,1,0,1394,1333,59
湖北,2020-03-30,0,2,0,1394,1335,59
湖北,2020-01-24,11,0,0,11,0,0
湖北,2020-01-25,6,0,0,17,0,0
湖北,2020-01-26,8,0,0,25,0,0
湖北,2020-01-27,13,0,0,38,0,0
湖北,2020-01-28,13,0,0,51,0,0
湖北,2020-01-29,15,0,0,66,0,0
湖北,2020-01-30,9,0,0,75,0,0
湖北,2020-01-31,12,0,0,87,0,0
湖北,2020-02-01,18,1,0,105,1,0
湖北,2020-02-02,6,4,0,111,5,0
湖北,2020-02-03,12,0,0,123,5,0
湖北,2020-02-04,15,1,0,138,6,0
湖北,2020-02-05,6,4,0,144,10,0
湖北,2020-02-06,13,0,0,157,10,0
湖北,2020-02-07,3,3,0,160,13,0
湖北,2020-02-08,11,7,0,171,20,0
湖北,2020-02-09,16,4,0,187,24,0
湖北,2020-02-10,8,7,2,195,31,2
湖北,2020-02-11,8,7,1,203,38,3
湖北,2020-02-12,26,10,1,229,48,4
湖北,2020-02-13,8,10,0,237,58,4
湖北,2020-02-14,7,13,0,244,71,4
湖北,2020-02-15,3,5,0,247,76,4
湖北,2020-02-16,2,5,0,249,81,4
湖北,2020-02-17,0,9,0,249,90,4
湖北,2020-02-18,0,6,0,249,96,4
湖北,2020-02-19,0,6,0,249,102,4
湖北,2020-02-20,1,10,0,250,112,4
湖北,2020-02-21,1,5,0,251,117,4
湖北,2020-02-22,0,6,0,251,123,4
湖北,2020-02-23,0,23,1,251,146,5
湖北,2020-02-24,0,5,0,251,151,5
湖北,2020-02-25,0,7,0,251,158,5
湖北,2020-02-26,0,6,0,251,164,5
湖北,2020-02-27,0,8,0,251,172,5
湖北,2020-02-28,1,9,0,252,181,5
湖北,2020-02-29,0,11,0,252,192,5
湖北,2020-03-01,0,1,0,252,193,5
湖北,2020-03-02,0,5,0,252,198,5
湖北,2020-03-03,0,7,0,252,205,5
湖北,2020-03-04,0,2,1,252,207,6
湖北,2020-03-05,0,19,1,252,226,7
湖北,2020-03-06,0,5,0,252,231,7
湖北,2020-03-08,0,2,0,252,233,7
湖北,2020-03-10,0,2,0,252,235,7
湖北,2020-03-12,0,1,0,252,236,7
湖北,2020-03-13,0,2,0,252,238,7
湖北,2020-03-14,0,3,0,252,241,7
湖北,2020-03-15,0,1,0,252,242,7
湖北,2020-03-16,0,1,0,252,243,7
湖北,2020-03-17,0,2,0,252,245,7
广西,2020-01-24,2,0,0,2,0,0
广西,2020-01-26,1,0,0,3,0,0
广西,2020-01-28,2,1,0,5,1,0
广西,2020-01-30,2,0,0,7,1,0
广西,2020-01-31,1,0,0,8,1,0
广西,2020-02-02,1,0,0,9,1,0
广西,2020-02-03,2,0,0,11,1,0
广西,2020-02-04,2,0,0,13,1,0
广西,2020-02-05,2,0,0,15,1,0
广西,2020-02-07,1,0,0,16,1,0
广西,2020-02-09,1,0,0,17,1,0
广西,2020-02-15,1,0,0,18,1,0
广西,2020-02-18,0,5,0,18,6,0
广西,2020-02-19,1,0,0,19,6,0
广西,2020-02-24,0,2,0,19,8,0
广西,2020-02-28,0,2,0,19,10,0
广西,2020-03-03,0,2,0,19,12,0
广西,2020-03-07,0,1,0,19,13,0
广西,2020-03-08,0,2,0,19,15,0
广西,2020-03-09,0,1,0,19,16,0
广西,2020-03-12,0,1,0,19,17,0
广西,2020-03-15,0,2,0,19,19,0
重庆,2020-01-24,1,0,0,1,0,0
重庆,2020-01-26,2,0,0,3,0,0
重庆,2020-01-31,1,0,0,4,0,0
重庆,2020-02-01,1,1,0,5,1,0
重庆,2020-02-03,1,0,0,6,1,0
重庆,2020-02-05,3,0,0,9,1,0
重庆,2020-02-10,1,0,0,10,1,0
重庆,2020-02-14,0,1,0,10,2,0
重庆,2020-02-15,0,1,0,10,3,0
重庆,2020-02-20,0,1,0,10,4,0
重庆,2020-02-27,0,1,0,10,5,0
重庆,2020-02-28,0,1,0,10,6,0
重庆,2020-03-02,0,1,0,10,7,0
重庆,2020-03-04,0,1,0,10,8,0
重庆,2020-03-12,0,2,0,10,10,0
江西,2020-01-24,2,0,0,2,0,0
江西,2020-01-25,5,0,0,7,0,0
江西,2020-01-27,3,0,0,10,0,0
江西,2020-01-28,6,0,0,16,0,0
江西,2020-01-29,5,0,0,21,0,0
江西,2020-01-30,6,0,0,27,0,0
江西,2020-01-31,3,1,0,30,1,0
江西,2020-02-01,4,0,0,34,1,0
江西,2020-02-02,1,0,0,35,1,0
江西,2020-02-03,7,0,0,42,1,0
江西,2020-02-04,6,0,0,48,1,0
江西,2020-02-05,4,1,0,52,2,0
江西,2020-02-06,7,0,0,59,2,0
江西,2020-02-07,5,0,0,64,2,0
江西,2020-02-08,5,0,0,69,2,0
江西,2020-02-09,2,4,1,71,6,1
江西,2020-02-10,1,1,0,72,7,1
江西,2020-02-11,0,1,0,72,8,1
江西,2020-02-12,4,2,0,76,10,1
江西,2020-02-13,0,2,0,76,12,1
江西,2020-02-14,0,2,0,76,14,1
江西,2020-02-15,0,3,0,76,17,1
江西,2020-02-16,0,1,0,76,18,1
江西,2020-02-17,0,2,0,76,20,1
江西,2020-02-18,0,4,0,76,24,1
江西,2020-02-19,0,4,0,76,28,1
江西,2020-02-20,0,6,0,76,34,1
江西,2020-02-21,0,6,0,76,40,1
江西,2020-02-22,0,7,0,76,47,1
江西,2020-02-23,0,2,0,76,49,1
江西,2020-02-24,0,4,0,76,53,1
江西,2020-02-25,0,4,0,76,57,1
江西,2020-02-26,0,4,0,76,61,1
江西,2020-02-27,0,2,0,76,63,1
江西,2020-02-28,0,7,0,76,70,1
江西,2020-02-29,0,1,0,76,71,1
江西,2020-03-01,0,1,0,76,72,1
江西,2020-03-02,0,1,0,76,73,1
江西,2020-03-04,0,1,0,76,74,1
江西,2020-03-05,0,1,0,76,75,1
宁夏,2020-01-24,1,0,0,1,0,0
宁夏,2020-01-30,1,0,0,2,0,0
宁夏,2020-02-08,0,2,0,2,2,0
宁夏,2020-02-09,1,0,0,3,2,0
宁夏,2020-02-12,2,0,0,5,2,0
宁夏,2020-02-18,0,1,0,5,3,0
宁夏,2020-02-23,0,1,0,5,4,0
宁夏,2020-02-26,0,1,0,5,5,0
重庆,2020-01-24,2,0,0,2,0,0
重庆,2020-01-26,1,0,0,3,0,0
重庆,2020-01-27,1,0,0,4,0,0
重庆,2020-01-28,1,0,0,5,0,0
重庆,2020-01-29,1,0,0,6,0,0
重庆,2020-01-31,2,0,0,8,0,0
重庆,2020-02-02,1,0,0,9,0,0
重庆,2020-02-05,2,0,0,11,0,0
重庆,2020-02-06,4,0,0,15,0,0
重庆,2020-02-07,1,1,0,16,1,0
重庆,2020-02-08,1,0,0,17,1,0
重庆,2020-02-09,1,1,0,18,2,0
重庆,2020-02-10,0,1,0,18,3,0
重庆,2020-02-11,2,0,0,20,3,0
重庆,2020-02-12,1,0,0,21,3,0
重庆,2020-02-13,2,2,0,23,5,0
重庆,2020-02-15,0,1,0,23,6,0
重庆,2020-02-17,0,1,0,23,7,0
重庆,2020-02-18,0,1,0,23,8,0
重庆,2020-02-21,0,2,0,23,10,0
重庆,2020-02-22,0,3,0,23,13,0
重庆,2020-02-24,0,1,0,23,14,0
重庆,2020-02-25,0,1,0,23,15,0
重庆,2020-02-29,0,3,0,23,18,0
重庆,2020-03-01,0,1,0,23,19,0
重庆,2020-03-02,0,1,0,23,20,0
重庆,2020-03-03,0,1,0,23,21,0
重庆,2020-03-05,0,2,0,23,23,0
湖南,2020-01-24,3,0,0,3,0,0
湖南,2020-01-26,1,0,0,4,0,0
湖南,2020-01-27,3,0,0,7,0,0
湖南,2020-01-28,10,0,0,17,0,0
湖南,2020-01-29,3,0,0,20,0,0
湖南,2020-01-30,5,0,0,25,0,0
湖南,2020-01-31,1,0,0,26,0,0
湖南,2020-02-01,4,0,0,30,0,0
湖南,2020-02-02,2,3,0,32,3,0
湖南,2020-02-03,3,1,0,35,4,0
湖南,2020-02-04,4,1,0,39,5,0
湖南,2020-02-05,4,0,0,43,5,0
湖南,2020-02-06,0,3,0,43,8,0
湖南,2020-02-07,0,3,0,43,11,0
湖南,2020-02-08,2,3,0,45,14,0
湖南,2020-02-10,0,2,0,45,16,0
湖南,2020-02-11,0,7,0,45,23,0
湖南,2020-02-13,1,2,0,46,25,0
湖南,2020-02-14,1,1,0,47,26,0
湖南,2020-02-15,0,2,0,47,28,0
湖南,2020-02-16,1,0,0,48,28,0
湖南,2020-02-18,0,1,0,48,29,0
湖南,2020-02-19,0,3,0,48,32,0
湖南,2020-02-20,0,5,0,48,37,0
湖南,2020-02-24,0,1,0,48,38,0
湖南,2020-02-28,0,6,0,48,44,0
湖南,2020-02-29,0,2,0,48,46,0
湖南,2020-03-02,0,2,0,48,48,0
辽宁,2020-01-24,2,0,0,2,0,0
辽宁,2020-01-28,1,0,0,3,0,0
辽宁,2020-01-29,1,0,0,4,0,0
辽宁,2020-01-31,1,0,0,5,0,0
辽宁,2020-02-04,1,0,0,6,0,0
辽宁,2020-02-05,1,0,0,7,0,0
辽宁,2020-02-07,2,0,0,9,0,0
辽宁,2020-02-11,2,0,0,11,0,0
辽宁,2020-02-12,0,0,1,11,0,1
辽宁,2020-02-15,1,0,0,12,0,1
辽宁,2020-02-18,0,2,0,12,2,1
辽宁,2020-02-19,0,2,0,12,4,1
辽宁,2020-02-20,0,1,0,12,5,1
辽宁,2020-02-25,0,1,0,12,6,1
辽宁,2020-02-29,0,1,0,12,7,1
辽宁,2020-03-03,0,1,0,12,8,1
辽宁,2020-03-07,0,1,0,12,9,1
辽宁,2020-03-16,0,2,0,12,11,1
山东,2020-01-24,2,0,0,2,0,0
山东,2020-01-25,1,0,0,3,0,0
山东,2020-01-26,4,0,0,7,0,0
山东,2020-01-27,3,0,0,10,0,0
山东,2020-01-28,1,0,0,11,0,0
山东,2020-01-29,3,0,0,14,0,0
山东,2020-01-30,2,0,0,16,0,0
山东,2020-01-31,2,0,0,18,0,0
山东,2020-02-01,1,0,0,19,0,0
山东,2020-02-02,3,0,0,22,0,0
山东,2020-02-03,3,0,0,25,0,0
山东,2020-02-04,4,0,0,29,0,0
山东,2020-02-05,4,0,0,33,0,0
山东,2020-02-06,6,3,0,39,3,0
山东,2020-02-07,3,0,0,42,3,0
山东,2020-02-09,2,4,0,44,7,0
山东,2020-02-10,2,0,0,46,7,0
山东,2020-02-11,1,0,0,47,7,0
山东,2020-02-13,0,4,0,47,11,0
山东,2020-02-17,0,2,0,47,13,0
山东,2020-02-18,0,3,0,47,16,0
山东,2020-02-19,0,1,0,47,17,0
山东,2020-02-20,0,1,0,47,18,0
山东,2020-02-21,0,4,0,47,22,0
山东,2020-02-22,0,2,0,47,24,0
山东,2020-02-26,0,1,0,47,25,0
山东,2020-02-28,0,1,0,47,26,0
山东,2020-02-29,0,3,0,47,29,0
山东,2020-03-01,0,3,0,47,32,0
山东,2020-03-03,0,4,0,47,36,0
山东,2020-03-04,0,1,0,47,37,0
山东,2020-03-05,0,1,0,47,38,0
山东,2020-03-06,0,2,0,47,40,0
山东,2020-03-08,0,3,0,47,43,0
山东,2020-03-09,0,1,0,47,44,0
山东,2020-03-10,0,1,0,47,45,0
山东,2020-03-11,0,1,0,47,46,0
山东,2020-03-21,0,1,0,47,47,0
山东,2020-01-24,2,0,0,2,0,0
山东,2020-01-25,2,0,0,4,0,0
山东,2020-01-26,1,0,0,5,0,0
山东,2020-01-29,3,0,0,8,0,0
山东,2020-01-31,2,0,0,10,0,0
山东,2020-02-01,4,1,0,14,1,0
山东,2020-02-02,4,0,0,18,1,0
山东,2020-02-03,3,0,0,21,1,0
山东,2020-02-04,2,2,0,23,3,0
山东,2020-02-05,9,0,0,32,3,0
山东,2020-02-06,3,1,0,35,4,0
山东,2020-02-07,3,3,0,38,7,0
山东,2020-02-08,1,1,0,39,8,0
山东,2020-02-10,2,0,0,41,8,0
山东,2020-02-11,1,1,0,42,9,0
山东,2020-02-12,1,3,0,43,12,0
山东,2020-02-13,3,2,0,46,14,0
山东,2020-02-14,3,1,0,49,15,0
山东,2020-02-15,2,3,0,51,18,0
山东,2020-02-16,1,0,0,52,18,0
山东,2020-02-17,30,2,0,82,20,0
山东,2020-02-18,20,2,0,102,22,0
山东,2020-02-19,15,5,0,117,27,0
山东,2020-02-20,1,2,0,118,29,0
山东,2020-02-22,4,2,0,122,31,0
山东,2020-02-24,10,3,0,132,34,0
山东,2020-02-25,1,1,0,133,35,0
山东,2020-02-26,20,8,0,153,43,0
山东,2020-02-28,35,2,0,188,45,0
山东,2020-02-29,43,1,0,231,46,0
山东,2020-03-01,2,0,0,233,46,0
山东,2020-03-02,23,35,0,256,81,0
山东,2020-03-03,4,2,0,260,83,0
山东,2020-03-04,0,58,0,260,141,0
山东,2020-03-05,0,22,0,260,163,0
山东,2020-03-06,0,11,0,260,174,0
山东,2020-03-07,0,4,0,260,178,0
山东,2020-03-09,0,51,0,260,229,0
山东,2020-03-10,0,13,0,260,242,0
山东,2020-03-11,0,6,0,260,248,0
山东,2020-03-12,0,5,0,260,253,0
山东,2020-03-13,0,1,0,260,254,0
山东,2020-03-15,0,2,0,260,256,0
山东,2020-03-18,0,1,0,260,257,0
山东,2020-03-19,0,1,0,260,258,0
山东,2020-03-20,0,1,0,260,259,0
山东,2020-03-23,0,1,0,260,260,0
江西,2020-01-24,1,0,0,1,0,0
江西,2020-01-26,1,0,0,2,0,0
江西,2020-01-30,1,1,0,3,1,0
江西,2020-02-03,1,0,0,4,1,0
江西,2020-02-08,1,0,0,5,1,0
江西,2020-02-16,1,2,0,6,3,0
江西,2020-03-01,0,1,0,6,4,0
江西,2020-03-02,0,1,0,6,5,0
江西,2020-03-03,0,1,0,6,6,0
云南,2020-01-24,1,0,0,1,0,0
云南,2020-01-25,1,0,0,2,0,0
云南,2020-01-27,4,0,0,6,0,0
云南,2020-02-02,1,0,0,7,0,0
云南,2020-02-06,0,1,0,7,1,0
云南,2020-02-10,0,1,0,7,2,0
云南,2020-02-15,0,3,0,7,5,0
云南,2020-02-18,0,2,0,7,7,0
重庆,2020-01-24,1,0,0,1,0,0
重庆,2020-01-30,1,0,0,2,0,0
重庆,2020-02-02,1,0,0,3,0,0
重庆,2020-02-06,1,0,0,4,0,0
重庆,2020-02-08,0,1,0,4,1,0
重庆,2020-02-12,0,1,0,4,2,0
重庆,2020-02-15,0,2,0,4,4,0
山东,2020-01-24,1,0,0,1,0,0
山东,2020-01-27,2,0,0,3,0,0
山东,2020-01-29,2,0,0,5,0,0
山东,2020-01-30,2,0,0,7,0,0
山东,2020-02-01,2,0,0,9,0,0
山东,2020-02-03,1,0,0,10,0,0
山东,2020-02-04,2,0,0,12,0,0
山东,2020-02-05,3,0,0,15,0,0
山东,2020-02-06,5,0,0,20,0,0
山东,2020-02-07,7,1,0,27,1,0
山东,2020-02-08,6,1,0,33,2,0
山东,2020-02-09,1,0,0,34,2,0
山东,2020-02-10,3,0,0,37,2,0
山东,2020-02-11,1,0,0,38,2,0
山东,2020-02-12,0,1,0,38,3,0
山东,2020-02-15,0,7,0,38,10,0
山东,2020-02-16,0,1,0,38,11,0
山东,2020-02-17,0,1,0,38,12,0
山东,2020-02-18,0,6,0,38,18,0
山东,2020-02-20,0,3,0,38,21,0
山东,2020-02-21,0,1,0,38,22,0
山东,2020-02-23,0,2,0,38,24,0
山东,2020-02-24,0,1,0,38,25,0
山东,2020-02-25,0,3,0,38,28,0
山东,2020-02-26,0,2,0,38,30,0
山东,2020-02-27,0,2,0,38,32,0
山东,2020-02-28,0,1,0,38,33,0
山东,2020-02-29,0,1,0,38,34,0
山东,2020-03-01,0,4,0,38,38,0
甘肃,2020-01-24,1,0,0,1,0,0
甘肃,2020-01-26,1,0,0,2,0,0
甘肃,2020-02-02,1,0,0,3,0,0
甘肃,2020-02-05,0,2,0,3,2,0
甘肃,2020-02-13,0,1,0,3,3,0
四川,2020-01-24,1,0,0,1,0,0
四川,2020-01-25,1,0,0,2,0,0
四川,2020-01-26,1,0,0,3,0,0
四川,2020-01-27,1,0,0,4,0,0
四川,2020-01-28,1,0,0,5,0,0
四川,2020-02-01,1,0,0,6,0,0
四川,2020-02-02,1,0,0,7,0,0
四川,2020-02-03,2,0,0,9,0,0
四川,2020-02-04,1,0,0,10,0,0
四川,2020-02-05,2,0,0,12,0,0
四川,2020-02-06,1,0,0,13,0,0
四川,2020-02-08,3,2,0,16,2,0
四川,2020-02-09,1,0,0,17,2,0
四川,2020-02-10,1,0,0,18,2,0
四川,2020-02-11,1,0,0,19,2,0
四川,2020-02-16,0,1,0,19,3,0
四川,2020-02-18,1,0,0,20,3,0
四川,2020-02-19,4,2,0,24,5,0
四川,2020-02-20,0,1,0,24,6,0
四川,2020-02-23,0,2,0,24,8,0
四川,2020-02-24,0,2,0,24,10,0
四川,2020-02-25,0,2,0,24,12,0
四川,2020-02-26,0,5,0,24,17,0
四川,2020-02-27,0,3,0,24,20,0
四川,2020-03-05,0,2,0,24,22,0
四川,2020-03-07,0,2,0,24,24,0
安徽,2020-01-24,4,0,0,4,0,0
安徽,2020-01-25,3,0,0,7,0,0
安徽,2020-01-27,3,0,0,10,0,0
安徽,2020-01-28,1,0,0,11,0,0
安徽,2020-01-29,3,0,0,14,0,0
安徽,2020-01-31,8,0,0,22,0,0
安徽,2020-02-01,5,0,0,27,0,0
安徽,2020-02-02,1,0,0,28,0,0
安徽,2020-02-04,2,0,0,30,0,0
安徽,2020-02-07,1,0,0,31,0,0
安徽,2020-02-08,0,2,0,31,2,0
安徽,2020-02-10,1,0,0,32,2,0
安徽,2020-02-11,0,2,0,32,4,0
安徽,2020-02-12,0,2,0,32,6,0
安徽,2020-02-13,2,2,0,34,8,0
安徽,2020-02-14,1,1,0,35,9,0
安徽,2020-02-15,1,1,0,36,10,0
安徽,2020-02-17,0,2,0,36,12,0
安徽,2020-02-18,1,2,0,37,14,0
安徽,2020-02-19,0,1,0,37,15,0
安徽,2020-02-21,1,2,0,38,17,0
安徽,2020-02-22,0,2,0,38,19,0
安徽,2020-02-24,0,1,0,38,20,0
安徽,2020-02-25,0,1,0,38,21,0
安徽,2020-02-26,0,4,0,38,25,0
安徽,2020-02-28,0,5,0,38,30,0
安徽,2020-02-29,0,3,0,38,33,0
安徽,2020-03-02,0,1,0,38,34,0
安徽,2020-03-03,0,1,0,38,35,0
安徽,2020-03-05,0,1,0,38,36,0
安徽,2020-03-06,0,2,0,38,38,0
河南,2020-01-24,8,0,0,8,0,0
河南,2020-01-25,7,0,1,15,0,1
河南,2020-01-26,4,0,0,19,0,1
河南,2020-01-27,7,0,0,26,0,1
河南,2020-01-28,5,0,1,31,0,2
河南,2020-01-29,20,0,0,51,0,2
河南,2020-01-30,10,0,0,61,0,2
河南,2020-01-31,5,0,0,66,0,2
河南,2020-02-01,10,0,0,76,0,2
河南,2020-02-02,8,1,0,84,1,2
河南,2020-02-03,15,0,0,99,1,2
河南,2020-02-04,8,0,0,107,1,2
河南,2020-02-05,4,0,0,111,1,2
河南,2020-02-06,7,0,0,118,1,2
河南,2020-02-07,10,0,0,128,1,2
河南,2020-02-08,5,0,0,133,1,2
河南,2020-02-09,1,0,0,134,1,2
河南,2020-02-10,2,0,0,136,1,2
河南,2020-02-11,2,0,0,138,1,2
河南,2020-02-12,7,0,0,145,1,2
河南,2020-02-13,1,0,0,146,1,2
河南,2020-02-14,4,1,0,150,2,2
河南,2020-02-15,1,0,0,151,2,2
河南,2020-02-16,3,0,0,154,2,2
河南,2020-02-17,1,0,0,155,2,2
河南,2020-02-26,1,0,0,156,2,2
四川,2020-01-24,1,0,0,1,0,0
四川,2020-01-27,2,0,0,3,0,0
四川,2020-01-28,1,0,0,4,0,0
四川,2020-01-30,2,0,0,6,0,0
四川,2020-01-31,4,0,0,10,0,0
四川,2020-02-01,1,0,0,11,0,0
四川,2020-02-02,1,0,0,12,0,0
四川,2020-02-03,3,0,0,15,0,0
四川,2020-02-05,1,0,0,16,0,0
四川,2020-02-06,1,0,0,17,0,0
四川,2020-02-07,0,1,0,17,1,0
四川,2020-02-08,0,1,0,17,2,0
四川,2020-02-10,1,0,0,18,2,0
四川,2020-02-11,2,0,0,20,2,0
四川,2020-02-12,1,1,0,21,3,0
四川,2020-02-14,1,2,0,22,5,0
四川,2020-02-17,0,1,0,22,6,0
四川,2020-02-20,0,4,0,22,10,0
四川,2020-02-23,0,1,0,22,11,0
四川,2020-02-24,0,2,0,22,13,0
四川,2020-02-26,0,2,0,22,15,0
四川,2020-02-27,0,3,0,22,18,0
四川,2020-03-04,0,1,0,22,19,0
四川,2020-03-07,0,1,0,22,20,0
四川,2020-03-08,0,1,0,22,21,0
四川,2020-03-11,0,1,0,22,22,0
河南,2020-01-24,1,0,0,1,0,0
河南,2020-01-25,1,0,0,2,0,0
河南,2020-01-26,3,0,0,5,0,0
河南,2020-01-29,3,0,0,8,0,0
河南,2020-01-30,2,0,0,10,0,0
河南,2020-01-31,1,0,0,11,0,0
河南,2020-02-01,3,0,0,14,0,0
河南,2020-02-02,5,0,0,19,0,0
河南,2020-02-03,9,0,0,28,0,0
河南,2020-02-04,6,0,0,34,0,0
河南,2020-02-05,7,0,0,41,0,0
河南,2020-02-06,5,0,1,46,0,1
河南,2020-02-07,2,1,0,48,1,1
河南,2020-02-08,2,6,0,50,7,1
河南,2020-02-09,2,6,0,52,13,1
河南,2020-02-10,2,0,0,54,13,1
河南,2020-02-11,1,2,0,55,15,1
河南,2020-02-12,1,3,0,56,18,1
河南,2020-02-13,1,0,0,57,18,1
河南,2020-02-14,1,1,0,58,19,1
河南,2020-02-15,0,1,0,58,20,1
河南,2020-02-16,0,4,0,58,24,1
河南,2020-02-17,0,3,0,58,27,1
河南,2020-02-18,0,4,0,58,31,1
河南,2020-02-19,0,3,0,58,34,1
河南,2020-02-20,0,5,0,58,39,1
河南,2020-02-22,0,3,0,58,42,1
河南,2020-02-23,0,1,0,58,43,1
河南,2020-02-24,0,1,0,58,44,1
河南,2020-02-26,0,5,0,58,49,1
河南,2020-02-27,0,2,0,58,51,1
河南,2020-02-28,0,2,0,58,53,1
河南,2020-02-29,0,4,0,58,57,1
广东,2020-01-24,1,0,0,1,0,0
广东,2020-01-25,1,0,0,2,0,0
广东,2020-01-27,3,0,0,5,0,0
广东,2020-01-28,1,0,0,6,0,0
广东,2020-01-29,6,0,0,12,0,0
广东,2020-01-31,2,0,0,14,0,0
广东,2020-02-02,3,0,0,17,0,0
广东,2020-02-03,1,0,0,18,0,0
广东,2020-02-04,2,3,0,20,3,0
广东,2020-02-06,2,0,0,22,3,0
广东,2020-02-07,3,0,0,25,3,0
广东,2020-02-09,0,2,0,25,5,0
广东,2020-02-12,0,2,0,25,7,0
广东,2020-02-13,0,1,0,25,8,0
广东,2020-02-14,0,1,0,25,9,0
广东,2020-02-15,0,2,0,25,11,0
广东,2020-02-16,0,2,0,25,13,0
广东,2020-02-17,0,1,0,25,14,0
广东,2020-02-18,0,1,0,25,15,0
广东,2020-02-19,0,3,0,25,18,0
广东,2020-02-20,0,2,0,25,20,0
广东,2020-02-22,0,1,0,25,21,0
广东,2020-02-26,0,1,0,25,22,0
广东,2020-03-07,0,2,0,25,24,0
陕西,2020-01-24,1,0,0,1,0,0
陕西,2020-01-27,1,0,0,2,0,0
陕西,2020-02-03,3,0,0,5,0,0
陕西,2020-02-04,1,0,0,6,0,0
陕西,2020-02-06,1,1,0,7,1,0
陕西,2020-02-15,0,2,0,7,3,0
陕西,2020-02-19,0,1,0,7,4,0
陕西,2020-02-23,0,1,0,7,5,0
陕西,2020-02-26,0,1,0,7,6,0
陕西,2020-03-08,0,1,0,7,7,0
江西,2020-01-24,2,0,0,2,0,0
江西,2020-01-25,4,0,0,6,0,0
江西,2020-01-27,1,0,0,7,0,0
江西,2020-01-28,2,0,0,9,0,0
江西,2020-01-29,2,0,0,11,0,0
江西,2020-01-30,1,1,0,12,1,0
江西,2020-01-31,4,0,0,16,1,0
江西,2020-02-01,3,0,0,19,1,0
江西,2020-02-02,13,3,0,32,4,0
江西,2020-02-03,18,0,0,50,4,0
江西,2020-02-04,19,1,0,69,5,0
江西,2020-02-05,9,0,0,78,5,0
江西,2020-02-06,8,0,0,86,5,0
江西,2020-02-07,6,0,0,92,5,0
江西,2020-02-08,6,2,0,98,7,0
江西,2020-02-09,5,5,0,103,12,0
江西,2020-02-10,8,1,0,111,13,0
江西,2020-02-11,5,2,0,116,15,0
江西,2020-02-12,3,2,0,119,17,0
江西,2020-02-13,3,1,0,122,18,0
江西,2020-02-14,1,2,0,123,20,0
江西,2020-02-15,0,11,0,123,31,0
江西,2020-02-16,0,4,0,123,35,0
江西,2020-02-17,0,4,0,123,39,0
江西,2020-02-18,0,8,0,123,47,0
江西,2020-02-19,0,8,0,123,55,0
江西,2020-02-20,0,9,0,123,64,0
江西,2020-02-21,0,11,0,123,75,0
江西,2020-02-22,0,13,0,123,88,0
江西,2020-02-23,0,2,0,123,90,0
江西,2020-02-24,0,7,0,123,97,0
江西,2020-02-25,0,4,0,123,101,0
江西,2020-02-27,0,8,0,123,109,0
江西,2020-02-28,0,2,0,123,111,0
江西,2020-03-01,0,5,0,123,116,0
江西,2020-03-02,0,4,0,123,120,0
江西,2020-03-03,0,1,0,123,121,0
江西,2020-03-04,0,1,0,123,122,0
江西,2020-03-10,0,1,0,123,123,0
湖南,2020-01-24,2,0,0,2,0,0
湖南,2020-01-26,6,0,0,8,0,0
湖南,2020-01-27,3,0,0,11,0,0
湖南,2020-01-28,8,0,0,19,0,0
湖南,2020-01-29,10,0,0,29,0,0
湖南,2020-01-30,7,0,0,36,0,0
湖南,2020-01-31,5,0,0,41,0,0
湖南,2020-02-01,8,1,0,49,1,0
湖南,2020-02-02,2,0,0,51,1,0
湖南,2020-02-03,4,0,0,55,1,0
湖南,2020-02-04,13,1,0,68,2,0
湖南,2020-02-05,6,1,0,74,3,0
湖南,2020-02-06,9,6,0,83,9,0
湖南,2020-02-07,3,2,0,86,11,0
湖南,2020-02-08,1,7,0,87,18,0
湖南,2020-02-09,2,3,0,89,21,0
湖南,2020-02-10,2,1,0,91,22,0
湖南,2020-02-11,3,3,1,94,25,1
湖南,2020-02-12,5,8,0,99,33,1
湖南,2020-02-13,1,8,0,100,41,1
湖南,2020-02-14,0,9,0,100,50,1
湖南,2020-02-15,1,9,0,101,59,1
湖南,2020-02-16,0,5,0,101,64,1
湖南,2020-02-17,0,3,0,101,67,1
湖南,2020-02-18,1,3,0,102,70,1
湖南,2020-02-19,0,1,0,102,71,1
湖南,2020-02-20,0,7,0,102,78,1
湖南,2020-02-21,0,2,0,102,80,1
湖南,2020-02-22,0,6,0,102,86,1
湖南,2020-02-23,0,2,0,102,88,1
湖南,2020-02-25,0,2,0,102,90,1
湖南,2020-02-27,0,2,0,102,92,1
湖南,2020-02-28,0,3,0,102,95,1
湖南,2020-03-01,0,4,0,102,99,1
湖南,2020-03-02,0,1,0,102,100,1
湖南,2020-03-13,0,1,0,102,101,1
重庆,2020-01-24,3,0,0,3,0,0
重庆,2020-01-27,3,0,0,6,0,0
重庆,2020-01-28,1,0,0,7,0,0
重庆,2020-01-31,3,0,0,10,0,0
重庆,2020-02-03,2,0,0,12,0,0
重庆,2020-02-10,2,2,0,14,2,0
重庆,2020-02-11,0,1,0,14,3,0
重庆,2020-02-14,0,2,0,14,5,0
重庆,2020-02-17,0,2,0,14,7,0
重庆,2020-02-18,0,1,0,14,8,0
重庆,2020-02-20,1,2,0,15,10,0
重庆,2020-02-21,0,1,0,15,11,0
重庆,2020-02-27,0,1,0,15,12,0
重庆,2020-03-01,0,1,0,15,13,0
重庆,2020-03-03,0,1,0,15,14,0
重庆,2020-03-09,0,1,0,15,15,0
湖北,2020-01-24,5,0,0,5,0,0
湖北,2020-01-25,31,0,0,36,0,0
湖北,2020-01-26,16,0,0,52,0,0
湖北,2020-01-27,18,0,0,70,0,0
湖北,2020-01-28,46,0,0,116,0,0
湖北,2020-01-29,27,0,0,143,0,0
湖北,2020-01-30,85,0,0,228,0,0
湖北,2020-01-31,76,0,1,304,0,1
湖北,2020-02-01,80,3,2,384,3,3
湖北,2020-02-02,74,0,2,458,3,5
湖北,2020-02-03,183,0,1,641,3,6
湖北,2020-02-04,65,6,2,706,9,8
湖北,2020-02-05,128,0,1,834,9,9
湖北,2020-02-06,81,0,0,915,9,9
湖北,2020-02-07,38,14,0,953,23,9
湖北,2020-02-08,31,0,0,984,23,9
湖北,2020-02-09,65,0,1,1049,23,10
湖北,2020-02-10,46,3,2,1095,26,12
湖北,2020-02-11,34,25,0,1129,51,12
湖北,2020-02-12,31,11,2,1160,62,14
湖北,2020-02-13,46,10,2,1206,72,16
湖北,2020-02-14,26,24,3,1232,96,19
湖北,2020-02-15,22,17,3,1254,113,22
湖北,2020-02-16,13,27,2,1267,140,24
湖北,2020-02-17,11,58,1,1278,198,25
湖北,2020-02-18,2,56,1,1280,254,26
湖北,2020-02-19,8,54,1,1288,308,27
湖北,2020-02-20,4,78,1,1292,386,28
湖北,2020-02-21,4,57,1,1296,443,29
湖北,2020-02-22,4,55,1,1300,498,30
湖北,2020-02-23,3,53,3,1303,551,33
湖北,2020-02-24,2,50,3,1305,601,36
湖北,2020-02-25,1,51,1,1306,652,37
湖北,2020-02-26,1,41,0,1307,693,37
湖北,2020-02-27,0,47,1,1307,740,38
湖北,2020-02-28,0,57,2,1307,797,40
湖北,2020-02-29,0,38,0,1307,835,40
湖北,2020-03-01,0,30,0,1307,865,40
湖北,2020-03-02,0,28,2,1307,893,42
湖北,2020-03-03,0,44,0,1307,937,42
湖北,2020-03-04,0,38,0,1307,975,42
湖北,2020-03-05,0,35,0,1307,1010,42
湖北,2020-03-06,0,38,1,1307,1048,43
湖北,2020-03-07,0,29,0,1307,1077,43
湖北,2020-03-08,0,27,1,1307,1104,44
湖北,2020-03-09,0,22,0,1307,1126,44
湖北,2020-03-10,0,25,0,1307,1151,44
湖北,2020-03-11,0,16,1,1307,1167,45
湖北,2020-03-12,0,14,0,1307,1181,45
湖北,2020-03-13,0,11,0,1307,1192,45
湖北,2020-03-14,0,21,0,1307,1213,45
湖北,2020-03-15,0,8,0,1307,1221,45
湖北,2020-03-17,0,1,0,1307,1222,45
湖北,2020-03-18,0,4,0,1307,1226,45
湖北,2020-03-19,0,10,0,1307,1236,45
湖北,2020-03-20,0,6,0,1307,1242,45
湖北,2020-03-21,0,10,0,1307,1252,45
湖北,2020-03-22,0,1,0,1307,1253,45
湖北,2020-03-23,0,5,0,1307,1258,45
湖北,2020-03-24,0,2,0,1307,1260,45
湖北,2020-03-25,0,2,0,1307,1262,45
湖北,2020-01-24,3,0,0,3,0,0
湖北,2020-01-25,2,0,0,5,0,0
湖北,2020-01-26,8,0,0,13,0,0
湖北,2020-01-27,10,0,2,23,0,2
湖北,2020-01-28,11,0,1,34,0,3
湖北,2020-01-29,10,0,0,44,0,3
湖北,2020-01-30,23,0,3,67,0,6
湖北,2020-01-31,15,0,1,82,0,7
湖北,2020-02-01,17,0,0,99,0,7
湖北,2020-02-02,16,0,3,115,0,10
湖北,2020-02-03,2,0,0,117,0,10
湖北,2020-02-04,11,0,0,128,0,10
湖北,2020-02-05,10,1,0,138,1,10
湖北,2020-02-06,25,0,0,163,1,10
湖北,2020-02-07,16,0,0,179,1,10
湖北,2020-02-08,18,0,0,197,1,10
湖北,2020-02-09,20,9,0,217,10,10
湖北,2020-02-10,44,2,0,261,12,10
湖北,2020-02-11,32,0,0,293,12,10
湖北,2020-02-12,69,1,0,362,13,10
湖北,2020-02-13,54,8,0,416,21,10
湖北,2020-02-14,6,0,0,422,21,10
湖北,2020-02-15,25,6,0,447,27,10
湖北,2020-02-16,38,12,0,485,39,10
湖北,2020-02-17,1,16,1,486,55,11
湖北,2020-02-18,0,18,0,486,73,11
湖北,2020-02-19,2,60,1,488,133,12
湖北,2020-02-20,4,32,0,492,165,12
湖北,2020-02-21,1,33,0,493,198,12
湖北,2020-02-22,1,34,1,494,232,13
湖北,2020-02-23,0,26,0,494,258,13
湖北,2020-02-24,1,24,0,495,282,13
湖北,2020-02-25,1,4,0,496,286,13
湖北,2020-02-26,0,21,0,496,307,13
湖北,2020-02-27,0,25,0,496,332,13
湖北,2020-02-28,0,30,0,496,362,13
湖北,2020-02-29,0,9,0,496,371,13
湖北,2020-03-01,0,22,1,496,393,14
湖北,2020-03-02,0,21,0,496,414,14
湖北,2020-03-03,0,7,0,496,421,14
湖北,2020-03-04,0,14,1,496,435,15
湖北,2020-03-05,0,7,0,496,442,15
湖北,2020-03-06,0,9,0,496,451,15
湖北,2020-03-07,0,6,0,496,457,15
湖北,2020-03-08,0,4,0,496,461,15
湖北,2020-03-09,0,10,0,496,471,15
湖北,2020-03-10,0,2,0,496,473,15
湖北,2020-03-11,0,1,0,496,474,15
湖北,2020-03-12,0,2,0,496,476,15
湖北,2020-03-14,0,1,0,496,477,15
湖北,2020-03-17,0,1,0,496,478,15
湖北,2020-03-18,0,1,0,496,479,15
湖北,2020-03-20,0,2,0,496,481,15
辽宁,2020-01-24,2,0,0,2,0,0
辽宁,2020-02-02,1,0,0,3,0,0
辽宁,2020-02-09,1,0,0,4,0,0
辽宁,2020-02-11,3,1,0,7,1,0
辽宁,2020-02-16,0,1,0,7,2,0
辽宁,2020-02-23,0,1,0,7,3,0
辽宁,2020-02-24,0,2,0,7,5,0
辽宁,2020-03-01,0,1,0,7,6,0
辽宁,2020-03-12,0,1,0,7,7,0
陕西,2020-01-24,3,0,0,3,0,0
陕西,2020-01-25,2,0,0,5,0,0
陕西,2020-02-01,1,0,0,6,0,0
陕西,2020-02-02,1,0,0,7,0,0
陕西,2020-02-06,1,1,0,8,1,0
陕西,2020-02-07,0,2,0,8,3,0
陕西,2020-02-08,0,1,0,8,4,0
陕西,2020-02-19,0,2,0,8,6,0
陕西,2020-03-02,0,1,0,8,7,0
陕西,2020-03-11,0,1,0,8,8,0
安徽,2020-01-24,3,0,0,3,0,0
安徽,2020-01-27,6,0,0,9,0,0
安徽,2020-01-29,1,0,0,10,0,0
安徽,2020-01-30,4,0,0,14,0,0
安徽,2020-01-31,2,0,0,16,0,0
安徽,2020-02-02,2,0,0,18,0,0
安徽,2020-02-03,1,1,0,19,1,0
安徽,2020-02-05,1,0,0,20,1,0
安徽,2020-02-06,2,1,0,22,2,0
安徽,2020-02-07,1,3,0,23,5,0
安徽,2020-02-08,1,2,0,24,7,0
安徽,2020-02-09,1,0,0,25,7,0
安徽,2020-02-10,2,0,0,27,7,0
安徽,2020-02-12,1,2,0,28,9,0
安徽,2020-02-13,0,1,0,28,10,0
安徽,2020-02-17,1,1,0,29,11,0
安徽,2020-02-18,0,1,0,29,12,0
安徽,2020-02-21,0,1,0,29,13,0
安徽,2020-02-22,0,1,0,29,14,0
安徽,2020-02-23,0,1,0,29,15,0
安徽,2020-02-24,0,3,0,29,18,0
安徽,2020-02-25,0,4,0,29,22,0
安徽,2020-02-27,0,4,0,29,26,0
安徽,2020-02-28,0,2,0,29,28,0
安徽,2020-02-29,0,1,0,29,29,0
安徽,2020-01-24,1,0,0,1,0,0
安徽,2020-01-25,2,0,0,3,0,0
安徽,2020-01-26,3,0,0,6,0,0
安徽,2020-01-27,3,0,0,9,0,0
安徽,2020-01-28,2,0,0,11,0,0
安徽,2020-01-29,3,0,0,14,0,0
安徽,2020-01-31,1,0,0,15,0,0
安徽,2020-02-01,1,0,0,16,0,0
安徽,2020-02-02,0,1,0,16,1,0
安徽,2020-02-03,5,0,0,21,1,0
安徽,2020-02-04,2,0,0,23,1,0
安徽,2020-02-05,3,1,0,26,2,0
安徽,2020-02-06,1,0,0,27,2,0
安徽,2020-02-07,2,1,0,29,3,0
安徽,2020-02-09,1,0,0,30,3,0
安徽,2020-02-10,1,0,0,31,3,0
安徽,2020-02-11,0,1,0,31,4,0
安徽,2020-02-13,0,1,0,31,5,0
安徽,2020-02-14,0,3,0,31,8,0
安徽,2020-02-15,0,3,0,31,11,0
安徽,2020-02-16,0,2,0,31,13,0
安徽,2020-02-17,2,0,0,33,13,0
安徽,2020-02-18,0,4,0,33,17,0
安徽,2020-02-20,0,4,0,33,21,0
安徽,2020-02-21,0,4,0,33,25,0
安徽,2020-02-23,0,2,0,33,27,0
安徽,2020-02-25,0,1,0,33,28,0
安徽,2020-02-27,1,2,0,34,30,0
安徽,2020-02-29,0,1,0,34,31,0
安徽,2020-03-02,0,2,0,34,33,0
安徽,2020-03-08,0,1,0,34,34,0
云南,2020-01-24,1,0,0,1,0,0
云南,2020-01-27,5,0,0,6,0,0
云南,2020-01-29,4,0,0,10,0,0
云南,2020-01-30,2,0,0,12,0,0
云南,2020-02-02,1,0,0,13,0,0
云南,2020-02-03,0,1,0,13,1,0
云南,2020-02-04,1,0,0,14,1,0
云南,2020-02-05,1,0,0,15,1,0
云南,2020-02-07,0,1,0,15,2,0
云南,2020-02-14,0,1,0,15,3,0
云南,2020-02-17,0,1,0,15,4,0
云南,2020-02-20,0,0,1,15,4,1
云南,2020-02-22,0,5,0,15,9,1
云南,2020-02-23,0,3,0,15,12,1
云南,2020-02-27,0,2,0,15,14,1
内蒙古,2020-01-24,1,0,0,1,0,0
内蒙古,2020-01-25,1,0,0,2,0,0
内蒙古,2020-02-05,0,1,0,2,1,0
内蒙古,2020-02-12,1,0,0,3,1,0
内蒙古,2020-02-13,2,0,0,5,1,0
内蒙古,2020-02-14,1,0,0,6,1,0
内蒙古,2020-02-16,2,0,0,8,1,0
内蒙古,2020-02-18,1,0,0,9,1,0
内蒙古,2020-02-23,0,1,0,9,2,0
内蒙古,2020-02-29,0,1,0,9,3,0
内蒙古,2020-03-03,0,5,0,9,8,0
内蒙古,2020-03-08,0,1,0,9,9,0
河南,2020-01-24,1,0,0,1,0,0
河南,2020-01-25,2,0,0,3,0,0
河南,2020-01-26,1,0,0,4,0,0
河南,2020-01-27,2,0,0,6,0,0
河南,2020-01-28,1,0,0,7,0,0
河南,2020-01-29,5,0,0,12,0,0
河南,2020-01-30,5,0,0,17,0,0
河南,2020-01-31,6,0,0,23,0,0
河南,2020-02-02,4,0,0,27,0,0
河南,2020-02-03,6,0,0,33,0,0
河南,2020-02-04,6,2,0,39,2,0
河南,2020-02-05,2,0,0,41,2,0
河南,2020-02-06,0,2,0,41,4,0
河南,2020-02-07,2,0,0,43,4,0
河南,2020-02-08,1,2,1,44,6,1
河南,2020-02-09,2,1,0,46,7,1
河南,2020-02-10,2,0,0,48,7,1
河南,2020-02-11,5,0,1,53,7,2
河南,2020-02-12,1,0,0,54,7,2
河南,2020-02-13,1,1,0,55,8,2
河南,2020-02-14,0,2,0,55,10,2
河南,2020-02-15,1,2,0,56,12,2
河南,2020-02-16,1,9,0,57,21,2
河南,2020-02-19,0,5,0,57,26,2
河南,2020-02-20,0,4,0,57,30,2
河南,2020-02-22,0,7,0,57,37,2
河南,2020-02-23,0,3,0,57,40,2
河南,2020-02-24,0,8,0,57,48,2
河南,2020-02-25,0,1,0,57,49,2
河南,2020-02-27,0,2,0,57,51,2
河南,2020-02-28,0,2,0,57,53,2
江苏,2020-01-24,1,0,0,1,0,0
江苏,2020-01-27,2,0,0,3,0,0
江苏,2020-01-28,1,0,0,4,0,0
江苏,2020-01-30,3,0,0,7,0,0
江苏,2020-01-31,1,0,0,8,0,0
江苏,2020-02-02,1,0,0,9,0,0
江苏,2020-02-03,1,0,0,10,0,0
江苏,2020-02-04,1,0,0,11,0,0
江苏,2020-02-06,1,0,0,12,0,0
江苏,2020-02-10,0,3,0,12,3,0
江苏,2020-02-11,0,3,0,12,6,0
江苏,2020-02-15,1,1,0,13,7,0
江苏,2020-02-21,0,1,0,13,8,0
江苏,2020-02-23,0,1,0,13,9,0
江苏,2020-02-24,0,2,0,13,11,0
江苏,2020-02-27,0,1,0,13,12,0
江苏,2020-03-02,0,1,0,13,13,0
山东,2020-01-24,2,0,0,2,0,0
山东,2020-01-26,2,0,0,4,0,0
山东,2020-01-27,4,0,0,8,0,0
山东,2020-01-28,2,0,0,10,0,0
山东,2020-01-29,3,0,0,13,0,0
山东,2020-01-30,5,0,0,18,0,0
山东,2020-01-31,2,0,0,20,0,0
山东,2020-02-02,2,0,0,22,0,0
山东,2020-02-03,4,0,0,26,0,0
山东,2020-02-05,3,0,0,29,0,0
山东,2020-02-06,2,2,0,31,2,0
山东,2020-02-07,3,0,0,34,2,0
山东,2020-02-08,2,0,0,36,2,0
山东,2020-02-09,3,1,0,39,3,0
山东,2020-02-10,2,0,0,41,3,0
山东,2020-02-11,2,0,0,43,3,0
山东,2020-02-12,3,4,0,46,7,0
山东,2020-02-13,0,3,0,46,10,0
山东,2020-02-14,0,2,0,46,12,0
山东,2020-02-15,0,1,0,46,13,0
山东,2020-02-16,1,0,0,47,13,0
山东,2020-02-19,0,2,0,47,15,0
山东,2020-02-20,0,2,0,47,17,0
山东,2020-02-21,0,1,0,47,18,0
山东,2020-02-22,0,1,0,47,19,0
山东,2020-02-24,0,1,0,47,20,0
山东,2020-02-25,0,3,0,47,23,0
山东,2020-02-26,0,3,0,47,26,0
山东,2020-02-27,0,2,0,47,28,0
山东,2020-02-28,0,2,0,47,30,0
山东,2020-02-29,0,1,0,47,31,0
山东,2020-03-01,0,2,0,47,33,0
山东,2020-03-02,0,2,0,47,35,0
山东,2020-03-03,0,2,0,47,37,0
山东,2020-03-04,0,2,0,47,39,0
山东,2020-03-06,0,1,0,47,40,0
山东,2020-03-07,0,1,0,47,41,0
山东,2020-03-08,0,1,0,47,42,0
山东,2020-03-09,0,1,0,47,43,0
山东,2020-03-10,0,1,0,47,44,0
山东,2020-03-11,0,3,0,47,47,0
江苏,2020-01-24,1,0,0,1,0,0
江苏,2020-01-28,5,0,0,6,0,0
江苏,2020-01-30,2,0,0,8,0,0
江苏,2020-01-31,5,0,0,13,0,0
江苏,2020-02-01,2,0,0,15,0,0
江苏,2020-02-05,1,2,0,16,2,0
江苏,2020-02-06,0,1,0,16,3,0
江苏,2020-02-07,1,0,0,17,3,0
江苏,2020-02-09,1,0,0,18,3,0
江苏,2020-02-11,3,0,0,21,3,0
江苏,2020-02-12,4,3,0,25,6,0
江苏,2020-02-13,1,0,0,26,6,0
江苏,2020-02-14,1,0,0,27,6,0
江苏,2020-02-15,0,3,0,27,9,0
江苏,2020-02-16,0,3,0,27,12,0
江苏,2020-02-17,0,2,0,27,14,0
江苏,2020-02-18,0,4,0,27,18,0
江苏,2020-02-19,0,2,0,27,20,0
江苏,2020-02-23,0,4,0,27,24,0
江苏,2020-02-26,0,1,0,27,25,0
江苏,2020-02-28,0,2,0,27,27,0
江西,2020-01-24,1,0,0,1,0,0
江西,2020-01-25,4,0,0,5,0,0
江西,2020-01-26,1,0,0,6,0,0
江西,2020-01-27,4,0,0,10,0,0
江西,2020-01-28,4,0,0,14,0,0
江西,2020-01-30,12,0,0,26,0,0
江西,2020-01-31,3,1,0,29,1,0
江西,2020-02-01,2,0,0,31,1,0
江西,2020-02-02,5,0,0,36,1,0
江西,2020-02-03,9,1,0,45,2,0
江西,2020-02-04,3,2,0,48,4,0
江西,2020-02-05,6,0,0,54,4,0
江西,2020-02-06,8,1,0,62,5,0
江西,2020-02-07,5,1,0,67,6,0
江西,2020-02-08,6,0,0,73,6,0
江西,2020-02-09,4,4,0,77,10,0
江西,2020-02-10,6,0,0,83,10,0
江西,2020-02-11,5,6,0,88,16,0
江西,2020-02-12,7,0,0,95,16,0
江西,2020-02-13,6,2,0,101,18,0
江西,2020-02-14,1,2,0,102,20,0
江西,2020-02-15,2,0,0,104,20,0
江西,2020-02-16,2,4,0,106,24,0
江西,2020-02-17,0,6,0,106,30,0
江西,2020-02-18,0,3,0,106,33,0
江西,2020-02-19,0,9,0,106,42,0
江西,2020-02-20,0,11,0,106,53,0
江西,2020-02-21,0,5,0,106,58,0
江西,2020-02-22,0,14,0,106,72,0
江西,2020-02-23,0,4,0,106,76,0
江西,2020-02-24,0,8,0,106,84,0
江西,2020-02-25,0,6,0,106,90,0
江西,2020-02-26,0,5,0,106,95,0
江西,2020-02-27,0,1,0,106,96,0
江西,2020-02-29,0,8,0,106,104,0
江西,2020-03-02,0,1,0,106,105,0
江西,2020-03-03,0,1,0,106,106,0
湖南,2020-01-24,4,0,0,4,0,0
湖南,2020-01-26,3,0,0,7,0,0
湖南,2020-01-27,3,0,0,10,0,0
湖南,2020-01-28,4,0,0,14,0,0
湖南,2020-01-29,3,0,0,17,0,0
湖南,2020-01-30,3,0,0,20,0,0
湖南,2020-01-31,4,0,0,24,0,0
湖南,2020-02-01,3,0,0,27,0,0
湖南,2020-02-02,3,0,0,30,0,0
湖南,2020-02-03,5,1,0,35,1,0
湖南,2020-02-04,5,0,0,40,1,0
湖南,2020-02-05,1,5,0,41,6,0
湖南,2020-02-06,2,0,0,43,6,0
湖南,2020-02-07,1,0,0,44,6,0
湖南,2020-02-08,2,4,0,46,10,0
湖南,2020-02-09,7,5,0,53,15,0
湖南,2020-02-10,1,1,0,54,16,0
湖南,2020-02-11,4,6,0,58,22,0
湖南,2020-02-12,1,0,0,59,22,0
湖南,2020-02-14,0,2,0,59,24,0
湖南,2020-02-15,0,1,0,59,25,0
湖南,2020-02-16,0,2,0,59,27,0
湖南,2020-02-17,0,3,0,59,30,0
湖南,2020-02-18,0,1,0,59,31,0
湖南,2020-02-19,0,4,0,59,35,0
湖南,2020-02-20,0,13,0,59,48,0
湖南,2020-02-21,0,3,0,59,51,0
湖南,2020-02-22,0,1,0,59,52,0
湖南,2020-02-24,0,3,0,59,55,0
湖南,2020-02-25,0,1,0,59,56,0
湖南,2020-02-27,0,2,0,59,58,0
湖南,2020-02-28,1,0,0,60,58,0
湖南,2020-02-29,0,1,0,60,59,0
湖南,2020-03-08,0,1,0,60,60,0
广西,2020-01-24,1,0,0,1,0,0
广西,2020-01-26,1,0,0,2,0,0
广西,2020-01-30,2,0,0,4,0,0
广西,2020-01-31,1,0,0,5,0,0
广西,2020-02-01,2,0,0,7,0,0
广西,2020-02-02,1,0,0,8,0,0
广西,2020-02-05,0,1,0,8,1,0
广西,2020-02-07,1,0,0,9,1,0
广西,2020-02-14,1,0,0,10,1,0
广西,2020-02-17,0,1,0,10,2,0
广西,2020-02-18,1,2,0,11,4,0
广西,2020-02-22,0,2,0,11,6,0
广西,2020-02-25,0,1,0,11,7,0
广西,2020-03-02,0,4,0,11,11,0
山西,2020-01-24,2,0,0,2,0,0
山西,2020-01-27,1,0,0,3,0,0
山西,2020-01-28,1,0,0,4,0,0
山西,2020-01-29,3,0,0,7,0,0
山西,2020-01-30,1,0,0,8,0,0
山西,2020-01-31,2,0,0,10,0,0
山西,2020-02-02,3,1,0,13,1,0
山西,2020-02-03,3,0,0,16,1,0
山西,2020-02-04,1,0,0,17,1,0
山西,2020-02-08,1,3,0,18,4,0
山西,2020-02-10,1,0,0,19,4,0
山西,2020-02-11,0,2,0,19,6,0
山西,2020-02-12,0,2,0,19,8,0
山西,2020-02-14,0,2,0,19,10,0
山西,2020-02-15,0,3,0,19,13,0
山西,2020-02-18,0,1,0,19,14,0
山西,2020-02-20,0,2,0,19,16,0
山西,2020-02-23,0,1,0,19,17,0
山西,2020-02-25,0,1,0,19,18,0
山西,2020-03-10,0,1,0,19,19,0
山西,2020-01-24,1,0,0,1,0,0
山西,2020-01-29,2,0,0,3,0,0
山西,2020-02-05,2,0,0,5,0,0
山西,2020-02-08,2,0,0,7,0,0
山西,2020-02-11,1,0,0,8,0,0
山西,2020-02-16,0,1,0,8,1,0
山西,2020-02-20,0,1,0,8,2,0
山西,2020-02-21,0,1,0,8,3,0
山西,2020-02-24,0,2,0,8,5,0
山西,2020-02-26,0,2,0,8,7,0
山西,2020-03-02,0,1,0,8,8,0
河南,2020-01-24,2,0,0,2,0,0
河南,2020-01-25,5,0,0,7,0,0
河南,2020-01-26,2,0,0,9,0,0
河南,2020-01-27,1,0,0,10,0,0
河南,2020-01-28,6,0,0,16,0,0
河南,2020-01-29,9,0,0,25,0,0
河南,2020-01-30,5,0,0,30,0,0
河南,2020-01-31,10,0,0,40,0,0
河南,2020-02-01,6,0,0,46,0,0
河南,2020-02-02,12,0,0,58,0,0
河南,2020-02-03,14,0,0,72,0,0
河南,2020-02-04,10,0,0,82,0,0
河南,2020-02-05,16,2,0,98,2,0
河南,2020-02-06,8,0,0,106,2,0
河南,2020-02-07,7,2,0,113,4,0
河南,2020-02-08,3,5,0,116,9,0
河南,2020-02-09,7,4,0,123,13,0
河南,2020-02-10,3,6,0,126,19,0
河南,2020-02-11,2,1,0,128,20,0
河南,2020-02-12,6,0,0,134,20,0
河南,2020-02-13,3,0,0,137,20,0
河南,2020-02-14,1,0,0,138,20,0
河南,2020-02-17,1,0,0,139,20,0
河南,2020-02-18,0,3,0,139,23,0
河南,2020-02-19,0,28,0,139,51,0
河南,2020-02-20,0,13,0,139,64,0
河南,2020-02-21,0,7,0,139,71,0
河南,2020-02-22,0,10,0,139,81,0
河南,2020-02-23,0,23,0,139,104,0
河南,2020-02-24,0,20,0,139,124,0
河南,2020-02-25,0,2,0,139,126,0
河南,2020-02-26,0,2,0,139,128,0
河南,2020-02-27,0,4,0,139,132,0
河南,2020-02-28,0,5,0,139,137,0
四川,2020-01-24,1,0,0,1,0,0
四川,2020-01-26,1,0,0,2,0,0
四川,2020-01-27,5,0,0,7,0,0
四川,2020-01-30,2,0,0,9,0,0
四川,2020-02-07,0,2,0,9,2,0
四川,2020-02-18,0,2,0,9,4,0
四川,2020-02-20,0,3,0,9,7,0
四川,2020-02-25,0,1,0,9,8,0
四川,2020-02-27,0,1,0,9,9,0
河南,2020-01-25,3,0,0,3,0,0
河南,2020-01-26,4,0,0,7,0,0
河南,2020-01-27,4,0,0,11,0,0
河南,2020-01-28,3,0,0,14,0,0
河南,2020-01-29,3,0,0,17,0,0
河南,2020-01-30,4,0,0,21,0,0
河南,2020-01-31,4,0,0,25,0,0
河南,2020-02-02,4,0,0,29,0,0
河南,2020-02-03,4,0,0,33,0,0
河南,2020-02-04,2,1,0,35,1,0
河南,2020-02-05,2,0,0,37,1,0
河南,2020-02-06,3,0,0,40,1,0
河南,2020-02-07,3,1,0,43,2,0
河南,2020-02-08,1,0,0,44,2,0
河南,2020-02-09,1,0,0,45,2,0
河南,2020-02-10,1,7,0,46,9,0
河南,2020-02-11,3,0,0,49,9,0
河南,2020-02-12,1,0,0,50,9,0
河南,2020-02-13,0,3,0,50,12,0
河南,2020-02-14,1,0,0,51,12,0
河南,2020-02-15,0,1,0,51,13,0
河南,2020-02-16,0,1,0,51,14,0
河南,2020-02-17,1,4,0,52,18,0
河南,2020-02-19,1,2,0,53,20,0
河南,2020-02-20,0,8,0,53,28,0
河南,2020-02-21,0,3,0,53,31,0
河南,2020-02-22,0,3,0,53,34,0
河南,2020-02-23,0,3,0,53,37,0
河南,2020-02-24,0,4,0,53,41,0
河南,2020-02-26,0,2,0,53,43,0
河南,2020-03-03,0,1,0,53,44,0
河南,2020-03-07,0,2,0,53,46,0
河南,2020-03-11,0,3,0,53,49,0
河南,2020-03-16,0,4,0,53,53,0
山东,2020-01-25,1,0,0,1,0,0
山东,2020-01-26,2,0,0,3,0,0
山东,2020-01-27,1,0,0,4,0,0
山东,2020-01-28,2,0,0,6,0,0
山东,2020-01-29,1,0,0,7,0,0
山东,2020-01-30,2,0,0,9,0,0
山东,2020-02-01,1,0,0,10,0,0
山东,2020-02-03,1,0,0,11,0,0
山东,2020-02-04,0,2,0,11,2,0
山东,2020-02-06,0,1,0,11,3,0
山东,2020-02-07,0,1,0,11,4,0
山东,2020-02-10,0,1,0,11,5,0
山东,2020-02-11,1,1,0,12,6,0
山东,2020-02-13,2,0,0,14,6,0
山东,2020-02-14,0,2,0,14,8,0
山东,2020-02-15,0,1,0,14,9,0
山东,2020-02-16,1,0,0,15,9,0
山东,2020-02-17,0,1,0,15,10,0
山东,2020-02-19,0,1,0,15,11,0
山东,2020-02-26,0,1,0,15,12,0
山东,2020-03-01,0,1,0,15,13,0
山东,2020-03-03,0,1,0,15,14,0
山东,2020-03-06,0,1,0,15,15,0
海南,2020-01-25,1,0,0,1,0,0
海南,2020-01-26,1,0,0,2,0,0
海南,2020-01-27,0,0,1,2,0,1
海南,2020-02-03,1,0,0,3,0,1
海南,2020-02-04,1,0,0,4,0,1
海南,2020-02-06,2,1,0,6,1,1
海南,2020-02-07,1,0,0,7,1,1
海南,2020-02-11,1,0,0,8,1,1
海南,2020-02-14,1,1,0,9,2,1
海南,2020-02-18,0,3,0,9,5,1
海南,2020-02-21,0,1,0,9,6,1
海南,2020-02-27,0,1,0,9,7,1
海南,2020-03-03,0,1,0,9,8,1
内蒙古,2020-01-25,1,0,0,1,0,0
内蒙古,2020-01-27,1,0,0,2,0,0
内蒙古,2020-02-04,1,0,0,3,0,0
内蒙古,2020-02-06,1,0,0,4,0,0
内蒙古,2020-02-07,0,1,0,4,1,0
内蒙古,2020-02-11,1,0,0,5,1,0
内蒙古,2020-02-12,0,1,0,5,2,0
内蒙古,2020-02-13,2,0,0,7,2,0
内蒙古,2020-02-15,2,0,0,9,2,0
内蒙古,2020-02-18,0,1,0,9,3,0
内蒙古,2020-02-25,0,1,0,9,4,0
内蒙古,2020-02-26,0,1,0,9,5,0
内蒙古,2020-02-27,0,3,0,9,8,0
内蒙古,2020-03-08,0,1,0,9,9,0
云南,2020-01-25,1,0,0,1,0,0
云南,2020-01-27,2,0,0,3,0,0
云南,2020-01-29,1,0,0,4,0,0
云南,2020-01-30,2,0,0,6,0,0
云南,2020-02-01,1,1,0,7,1,0
云南,2020-02-05,1,0,0,8,1,0
云南,2020-02-06,3,0,0,11,1,0
云南,2020-02-07,0,1,0,11,2,0
云南,2020-02-10,2,0,0,13,2,0
云南,2020-02-12,0,1,0,13,3,0
云南,2020-02-14,0,3,0,13,6,0
云南,2020-02-18,0,4,0,13,10,0
云南,2020-02-22,0,1,0,13,11,0
云南,2020-02-24,0,1,0,13,12,0
云南,2020-02-29,0,1,0,13,13,0
重庆,2020-01-25,1,0,0,1,0,0
重庆,2020-01-29,1,0,0,2,0,0
重庆,2020-01-30,2,0,0,4,0,0
重庆,2020-02-02,1,0,0,5,0,0
重庆,2020-02-03,2,0,0,7,0,0
重庆,2020-02-06,1,0,0,8,0,0
重庆,2020-02-07,2,0,0,10,0,0
重庆,2020-02-09,1,0,0,11,0,0
重庆,2020-02-10,3,1,0,14,1,0
重庆,2020-02-15,0,1,0,14,2,0
重庆,2020-02-16,0,1,0,14,3,0
重庆,2020-02-17,0,2,0,14,5,0
重庆,2020-02-18,0,3,0,14,8,0
重庆,2020-02-19,0,1,0,14,9,0
重庆,2020-02-25,0,1,0,14,10,0
重庆,2020-03-03,0,1,0,14,11,0
重庆,2020-03-04,0,1,0,14,12,0
重庆,2020-03-09,0,1,0,14,13,0
重庆,2020-03-14,0,1,0,14,14,0
甘肃,2020-01-25,1,0,0,1,0,0
甘肃,2020-01-29,1,0,0,2,0,0
甘肃,2020-02-01,1,0,0,3,0,0
甘肃,2020-02-02,0,1,0,3,1,0
甘肃,2020-02-05,2,0,0,5,1,0
甘肃,2020-02-07,3,0,0,8,1,0
甘肃,2020-02-10,0,1,0,8,2,0
甘肃,2020-02-13,1,2,0,9,4,0
甘肃,2020-02-15,0,4,0,9,8,0
甘肃,2020-03-14,0,1,0,9,9,0
北京,2020-01-25,1,0,0,1,0,0
北京,2020-01-27,1,0,0,2,0,0
北京,2020-02-04,4,0,0,6,0,0
北京,2020-02-05,1,0,0,7,0,0
北京,2020-02-07,1,0,0,8,0,0
北京,2020-02-08,1,0,0,9,0,0
北京,2020-02-11,3,0,0,12,0,0
北京,2020-02-23,1,0,0,13,0,0
北京,2020-03-06,1,0,0,14,0,0
北京,2020-06-14,1,0,0,15,0,0
北京,2020-06-15,1,0,0,16,0,0
北京,2020-06-16,3,0,0,19,0,0
内蒙古,2020-01-25,2,0,0,2,0,0
内蒙古,2020-01-29,1,0,0,3,0,0
内蒙古,2020-01-31,2,0,0,5,0,0
内蒙古,2020-02-01,1,0,0,6,0,0
内蒙古,2020-02-02,3,0,0,9,0,0
内蒙古,2020-02-04,2,0,0,11,0,0
内蒙古,2020-02-05,0,2,0,11,2,0
内蒙古,2020-02-15,0,1,0,11,3,0
内蒙古,2020-02-20,0,2,0,11,5,0
内蒙古,2020-02-21,0,2,0,11,7,0
内蒙古,2020-02-24,0,2,0,11,9,0
内蒙古,2020-02-29,0,1,0,11,10,0
内蒙古,2020-03-05,0,1,0,11,11,0
四川,2020-01-25,2,0,0,2,0,0
四川,2020-01-27,1,0,0,3,0,0
四川,2020-01-29,2,0,0,5,0,0
四川,2020-02-02,1,0,0,6,0,0
四川,2020-02-03,2,0,0,8,0,0
四川,2020-02-04,2,0,0,10,0,0
四川,2020-02-05,2,0,0,12,0,0
四川,2020-02-06,5,0,0,17,0,0
四川,2020-02-09,6,0,0,23,0,0
四川,2020-02-10,4,2,0,27,2,0
四川,2020-02-11,9,0,0,36,2,0
四川,2020-02-12,1,1,0,37,3,0
四川,2020-02-13,6,0,0,43,3,0
四川,2020-02-14,1,0,0,44,3,0
四川,2020-02-15,6,0,0,50,3,0
四川,2020-02-16,7,0,0,57,3,0
四川,2020-02-17,5,3,0,62,6,0
四川,2020-02-18,3,2,0,65,8,0
四川,2020-02-19,2,0,0,67,8,0
四川,2020-02-20,1,1,0,68,9,0
四川,2020-02-21,1,1,0,69,10,0
四川,2020-02-22,0,2,0,69,12,0
四川,2020-02-24,0,6,0,69,18,0
四川,2020-02-25,2,0,0,71,18,0
四川,2020-02-26,3,0,0,74,18,0
四川,2020-02-27,4,2,0,78,20,0
四川,2020-02-28,0,11,0,78,31,0
四川,2020-02-29,0,9,0,78,40,0
四川,2020-03-01,0,7,0,78,47,0
四川,2020-03-03,0,6,0,78,53,0
四川,2020-03-04,0,4,0,78,57,0
四川,2020-03-05,0,1,0,78,58,0
四川,2020-03-06,0,8,0,78,66,0
四川,2020-03-08,0,5,0,78,71,0
四川,2020-03-11,0,3,0,78,74,0
四川,2020-03-12,0,2,0,78,76,0
四川,2020-03-15,0,1,0,78,77,0
四川,2020-03-19,0,1,0,78,78,0
河北,2020-01-25,2,0,0,2,0,0
河北,2020-01-27,2,0,0,4,0,0
河北,2020-01-29,2,0,0,6,0,0
河北,2020-01-30,1,0,0,7,0,0
河北,2020-01-31,3,0,0,10,0,0
河北,2020-02-01,1,0,0,11,0,0
河北,2020-02-03,3,0,0,14,0,0
河北,2020-02-05,4,0,0,18,0,0
河北,2020-02-06,4,2,0,22,2,0
河北,2020-02-07,4,0,0,26,2,0
河北,2020-02-08,1,0,0,27,2,0
河北,2020-02-10,0,1,0,27,3,0
河北,2020-02-11,2,0,0,29,3,0
河北,2020-02-12,2,2,0,31,5,0
河北,2020-02-13,0,2,0,31,7,0
河北,2020-02-14,0,2,0,31,9,0
河北,2020-02-16,0,1,0,31,10,0
河北,2020-02-18,0,2,0,31,12,0
河北,2020-02-19,0,1,0,31,13,0
河北,2020-02-20,0,4,0,31,17,0
河北,2020-02-21,0,2,0,31,19,0
河北,2020-02-22,1,3,0,32,22,0
河北,2020-02-23,0,4,0,32,26,0
河北,2020-02-24,0,1,0,32,27,0
河北,2020-02-25,0,1,0,32,28,0
河北,2020-02-26,0,1,0,32,29,0
河北,2020-02-27,0,1,0,32,30,0
河北,2020-02-29,0,1,0,32,31,0
河北,2020-03-07,0,1,0,32,32,0
陕西,2020-01-25,1,0,0,1,0,0
陕西,2020-01-26,2,0,0,3,0,0
陕西,2020-01-27,1,0,0,4,0,0
陕西,2020-01-28,2,0,0,6,0,0
陕西,2020-01-30,5,0,0,11,0,0
陕西,2020-01-31,2,0,0,13,0,0
陕西,2020-02-01,2,0,0,15,0,0
陕西,2020-02-03,1,0,0,16,0,0
陕西,2020-02-04,3,0,0,19,0,0
陕西,2020-02-05,1,0,0,20,0,0
陕西,2020-02-06,1,0,0,21,0,0
陕西,2020-02-11,0,1,0,21,1,0
陕西,2020-02-15,4,0,0,25,1,0
陕西,2020-02-17,0,1,0,25,2,0
陕西,2020-02-18,1,3,0,26,5,0
陕西,2020-02-20,0,5,0,26,10,0
陕西,2020-02-29,0,11,0,26,21,0
陕西,2020-03-04,0,2,0,26,23,0
陕西,2020-03-06,0,2,0,26,25,0
陕西,2020-03-16,0,1,0,26,26,0
山东,2020-01-25,1,0,0,1,0,0
山东,2020-01-26,2,0,0,3,0,0
山东,2020-01-27,1,0,0,4,0,0
山东,2020-01-28,3,0,0,7,0,0
山东,2020-01-31,1,0,0,8,0,0
山东,2020-02-02,1,0,0,9,0,0
山东,2020-02-03,1,0,0,10,0,0
山东,2020-02-04,2,0,0,12,0,0
山东,2020-02-05,0,2,0,12,2,0
山东,2020-02-06,1,0,0,13,2,0
山东,2020-02-07,1,0,0,14,2,0
山东,2020-02-08,0,1,0,14,3,0
山东,2020-02-09,2,2,0,16,5,0
山东,2020-02-10,1,1,0,17,6,0
山东,2020-02-11,1,0,0,18,6,0
山东,2020-02-12,0,1,0,18,7,0
山东,2020-02-14,0,2,0,18,9,0
山东,2020-02-15,0,2,0,18,11,0
山东,2020-02-16,0,2,0,18,13,0
山东,2020-02-20,0,1,0,18,14,0
山东,2020-02-22,0,1,0,18,15,0
山东,2020-02-23,0,1,0,18,16,0
山东,2020-02-24,0,1,0,18,17,0
山东,2020-03-02,0,1,0,18,18,0
云南,2020-01-25,1,0,0,1,0,0
云南,2020-01-27,1,0,0,2,0,0
云南,2020-01-29,2,0,0,4,0,0
云南,2020-01-31,0,1,0,4,1,0
云南,2020-02-01,1,0,0,5,1,0
云南,2020-02-09,0,1,0,5,2,0
云南,2020-02-10,1,0,0,6,2,0
云南,2020-02-11,1,0,0,7,2,0
云南,2020-02-12,0,1,0,7,3,0
云南,2020-02-13,1,0,0,8,3,0
云南,2020-02-20,1,0,0,9,3,0
云南,2020-02-21,0,1,0,9,4,0
云南,2020-02-25,0,1,0,9,5,0
云南,2020-02-27,0,2,0,9,7,0
云南,2020-02-28,0,1,0,9,8,0
云南,2020-03-01,0,1,0,9,9,0
浙江,2020-01-25,1,0,0,1,0,0
浙江,2020-01-26,2,0,0,3,0,0
浙江,2020-01-28,2,0,0,5,0,0
浙江,2020-01-30,1,0,0,6,0,0
浙江,2020-02-02,3,0,0,9,0,0
浙江,2020-02-03,0,1,0,9,1,0
浙江,2020-02-07,1,0,0,10,1,0
浙江,2020-02-10,0,2,0,10,3,0
浙江,2020-02-11,0,1,0,10,4,0
浙江,2020-02-17,0,1,0,10,5,0
浙江,2020-02-19,0,1,0,10,6,0
浙江,2020-02-22,0,1,0,10,7,0
浙江,2020-02-27,0,2,0,10,9,0
浙江,2020-03-02,0,1,0,10,10,0
江苏,2020-01-25,1,0,0,1,0,0
江苏,2020-01-26,1,0,0,2,0,0
江苏,2020-01-28,1,0,0,3,0,0
江苏,2020-01-29,4,0,0,7,0,0
江苏,2020-01-30,3,0,0,10,0,0
江苏,2020-01-31,2,0,0,12,0,0
江苏,2020-02-01,1,1,0,13,1,0
江苏,2020-02-02,5,0,0,18,1,0
江苏,2020-02-03,4,0,0,22,1,0
江苏,2020-02-04,4,0,0,26,1,0
江苏,2020-02-05,8,0,0,34,1,0
江苏,2020-02-06,3,1,0,37,2,0
江苏,2020-02-07,3,0,0,40,2,0
江苏,2020-02-08,4,0,0,44,2,0
江苏,2020-02-09,2,3,0,46,5,0
江苏,2020-02-11,1,1,0,47,6,0
江苏,2020-02-12,4,0,0,51,6,0
江苏,2020-02-13,5,0,0,56,6,0
江苏,2020-02-14,4,5,0,60,11,0
江苏,2020-02-15,3,2,0,63,13,0
江苏,2020-02-16,2,8,0,65,21,0
江苏,2020-02-17,1,7,0,66,28,0
江苏,2020-02-19,0,4,0,66,32,0
江苏,2020-02-20,0,2,0,66,34,0
江苏,2020-02-21,0,1,0,66,35,0
江苏,2020-02-22,0,3,0,66,38,0
江苏,2020-02-23,0,1,0,66,39,0
江苏,2020-02-24,0,7,0,66,46,0
江苏,2020-02-26,0,4,0,66,50,0
江苏,2020-02-28,0,5,0,66,55,0
江苏,2020-03-01,0,2,0,66,57,0
江苏,2020-03-03,0,1,0,66,58,0
江苏,2020-03-04,0,4,0,66,62,0
江苏,2020-03-06,0,1,0,66,63,0
江苏,2020-03-09,0,3,0,66,66,0
安徽,2020-01-25,1,0,0,1,0,0
安徽,2020-01-27,1,0,0,2,0,0
安徽,2020-01-31,4,0,0,6,0,0
安徽,2020-02-02,2,0,0,8,0,0
安徽,2020-02-03,3,0,0,11,0,0
安徽,2020-02-04,3,0,0,14,0,0
安徽,2020-02-05,3,0,0,17,0,0
安徽,2020-02-06,5,0,0,22,0,0
安徽,2020-02-08,1,1,0,23,1,0
安徽,2020-02-09,0,3,0,23,4,0
安徽,2020-02-10,1,1,0,24,5,0
安徽,2020-02-12,1,1,0,25,6,0
安徽,2020-02-14,1,0,0,26,6,0
安徽,2020-02-15,0,4,0,26,10,0
安徽,2020-02-16,1,0,0,27,10,0
安徽,2020-02-17,0,1,0,27,11,0
安徽,2020-02-18,0,2,0,27,13,0
安徽,2020-02-20,0,1,0,27,14,0
安徽,2020-02-21,0,1,0,27,15,0
安徽,2020-02-23,0,2,0,27,17,0
安徽,2020-02-25,0,3,0,27,20,0
安徽,2020-02-26,0,2,0,27,22,0
安徽,2020-02-29,0,2,0,27,24,0
安徽,2020-03-04,0,1,0,27,25,0
安徽,2020-03-05,0,2,0,27,27,0
安徽,2020-01-25,1,0,0,1,0,0
安徽,2020-01-26,1,0,0,2,0,0
安徽,2020-01-29,4,0,0,6,0,0
安徽,2020-02-02,1,0,0,7,0,0
安徽,2020-02-03,1,0,0,8,0,0
安徽,2020-02-04,4,0,0,12,0,0
安徽,2020-02-05,0,2,0,12,2,0
安徽,2020-02-06,2,0,0,14,2,0
安徽,2020-02-07,7,0,0,21,2,0
安徽,2020-02-08,1,1,0,22,3,0
安徽,2020-02-09,1,1,0,23,4,0
安徽,2020-02-11,0,2,0,23,6,0
安徽,2020-02-15,1,1,0,24,7,0
安徽,2020-02-16,1,1,0,25,8,0
安徽,2020-02-17,2,0,0,27,8,0
安徽,2020-02-18,0,3,0,27,11,0
安徽,2020-02-19,0,1,0,27,12,0
安徽,2020-02-20,0,2,0,27,14,0
安徽,2020-02-22,0,1,0,27,15,0
安徽,2020-02-24,0,3,0,27,18,0
安徽,2020-02-26,0,2,0,27,20,0
安徽,2020-02-27,0,1,0,27,21,0
安徽,2020-03-01,0,1,0,27,22,0
安徽,2020-03-02,0,1,0,27,23,0
安徽,2020-03-03,0,1,0,27,24,0
安徽,2020-03-06,0,3,0,27,27,0
安徽,2020-01-25,1,0,0,1,0,0
安徽,2020-01-27,3,0,0,4,0,0
安徽,2020-01-28,3,0,0,7,0,0
安徽,2020-01-30,2,0,0,9,0,0
安徽,2020-02-07,0,1,0,9,1,0
安徽,2020-02-17,0,2,0,9,3,0
安徽,2020-02-19,0,3,0,9,6,0
安徽,2020-02-29,0,1,0,9,7,0
安徽,2020-03-02,0,1,0,9,8,0
安徽,2020-03-04,0,1,0,9,9,0
湖北,2020-01-25,31,0,1,31,0,1
湖北,2020-01-26,5,0,0,36,0,1
湖北,2020-01-27,17,0,0,53,0,1
湖北,2020-01-28,33,0,0,86,0,1
湖北,2020-01-29,27,0,0,113,0,1
湖北,2020-01-30,55,0,0,168,0,1
湖北,2020-01-31,41,0,1,209,0,2
湖北,2020-02-01,43,1,0,252,1,2
湖北,2020-02-02,82,8,0,334,9,2
湖北,2020-02-03,71,1,0,405,10,2
湖北,2020-02-04,104,8,0,509,18,2
湖北,2020-02-05,57,7,0,566,25,2
湖北,2020-02-06,69,6,0,635,31,2
湖北,2020-02-07,68,12,0,703,43,2
湖北,2020-02-08,50,10,0,753,53,2
湖北,2020-02-09,52,14,1,805,67,3
湖北,2020-02-10,30,15,2,835,82,5
湖北,2020-02-11,39,14,1,874,96,6
湖北,2020-02-12,37,17,3,911,113,9
湖北,2020-02-13,32,24,2,943,137,11
湖北,2020-02-14,37,33,2,980,170,13
湖北,2020-02-15,3,22,1,983,192,14
湖北,2020-02-16,0,14,1,983,206,15
湖北,2020-02-17,0,9,5,983,215,20
湖北,2020-02-18,0,47,5,983,262,25
湖北,2020-02-19,2,37,1,985,299,26
湖北,2020-02-20,7,40,1,992,339,27
湖北,2020-02-21,5,52,1,997,391,28
湖北,2020-02-22,4,51,1,1001,442,29
湖北,2020-02-23,4,48,1,1005,490,30
湖北,2020-02-24,3,44,1,1008,534,31
湖北,2020-02-25,3,51,1,1011,585,32
湖北,2020-02-26,2,28,1,1013,613,33
湖北,2020-02-27,0,40,0,1013,653,33
湖北,2020-02-28,0,22,1,1013,675,34
湖北,2020-02-29,1,22,0,1014,697,34
湖北,2020-03-01,0,32,1,1014,729,35
湖北,2020-03-02,0,23,0,1014,752,35
湖北,2020-03-03,0,31,1,1014,783,36
湖北,2020-03-04,1,39,0,1015,822,36
湖北,2020-03-05,0,37,0,1015,859,36
湖北,2020-03-06,0,18,0,1015,877,36
湖北,2020-03-07,0,7,0,1015,884,36
湖北,2020-03-08,0,13,1,1015,897,37
湖北,2020-03-09,0,9,0,1015,906,37
湖北,2020-03-10,0,11,1,1015,917,38
湖北,2020-03-11,0,4,0,1015,921,38
湖北,2020-03-12,0,17,0,1015,938,38
湖北,2020-03-13,0,2,0,1015,940,38
湖北,2020-03-14,0,8,0,1015,948,38
湖北,2020-03-15,0,2,0,1015,950,38
湖北,2020-03-16,0,10,0,1015,960,38
湖北,2020-03-17,0,3,0,1015,963,38
湖北,2020-03-18,0,1,0,1015,964,38
湖北,2020-03-19,0,3,0,1015,967,38
湖北,2020-03-20,0,5,0,1015,972,38
湖北,2020-03-21,0,1,0,1015,973,38
湖北,2020-03-24,0,1,1,1015,974,39
湖北,2020-03-25,0,1,0,1015,975,39
湖北,2020-03-27,0,1,0,1015,976,39
重庆,2020-01-25,2,0,0,2,0,0
重庆,2020-01-26,1,0,0,3,0,0
重庆,2020-01-27,1,0,0,4,0,0
重庆,2020-01-28,1,0,0,5,0,0
重庆,2020-01-29,1,0,0,6,0,0
重庆,2020-01-30,2,0,0,8,0,0
重庆,2020-01-31,4,0,0,12,0,0
重庆,2020-02-01,1,0,0,13,0,0
重庆,2020-02-02,3,0,0,16,0,0
重庆,2020-02-05,2,0,0,18,0,0
重庆,2020-02-06,1,0,0,19,0,0
重庆,2020-02-07,1,1,0,20,1,0
重庆,2020-02-08,3,0,0,23,1,0
重庆,2020-02-09,1,0,0,24,1,0
重庆,2020-02-10,1,0,0,25,1,0
重庆,2020-02-11,0,1,0,25,2,0
重庆,2020-02-14,1,1,0,26,3,0
重庆,2020-02-15,1,0,0,27,3,0
重庆,2020-02-16,1,0,0,28,3,0
重庆,2020-02-17,0,2,0,28,5,0
重庆,2020-02-18,0,3,0,28,8,0
重庆,2020-02-19,0,1,0,28,9,0
重庆,2020-02-21,0,1,0,28,10,0
重庆,2020-02-23,0,1,0,28,11,0
重庆,2020-02-25,0,3,0,28,14,0
重庆,2020-02-26,0,2,0,28,16,0
重庆,2020-02-27,0,1,0,28,17,0
重庆,2020-02-28,0,2,0,28,19,0
重庆,2020-02-29,0,2,0,28,21,0
重庆,2020-03-01,0,1,0,28,22,0
重庆,2020-03-02,0,1,0,28,23,0
重庆,2020-03-03,0,2,0,28,25,0
重庆,2020-03-10,0,1,0,28,26,0
重庆,2020-03-11,0,1,0,28,27,0
重庆,2020-03-12,0,1,0,28,28,0
广东,2020-01-25,3,0,0,3,0,0
广东,2020-01-27,1,0,0,4,0,0
广东,2020-01-28,2,0,0,6,0,0
广东,2020-02-05,1,0,0,7,0,0
广东,2020-02-08,0,1,0,7,1,0
广东,2020-02-10,1,0,0,8,1,0
广东,2020-02-11,0,2,0,8,3,0
广东,2020-02-14,0,1,0,8,4,0
广东,2020-02-26,0,1,0,8,5,0
广东,2020-03-06,0,3,0,8,8,0
广东,2020-04-04,2,0,0,10,8,0
山西,2020-01-25,2,0,0,2,0,0
山西,2020-01-27,3,0,0,5,0,0
山西,2020-01-28,4,0,0,9,0,0
山西,2020-01-31,2,0,0,11,0,0
山西,2020-02-01,2,0,0,13,0,0
山西,2020-02-02,2,0,0,15,0,0
山西,2020-02-03,4,0,0,19,0,0
山西,2020-02-04,2,2,0,21,2,0
山西,2020-02-05,5,0,0,26,2,0
山西,2020-02-06,1,3,0,27,5,0
山西,2020-02-07,3,0,0,30,5,0
山西,2020-02-08,2,1,0,32,6,0
山西,2020-02-09,0,2,0,32,8,0
山西,2020-02-10,1,0,0,33,8,0
山西,2020-02-11,1,0,0,34,8,0
山西,2020-02-12,1,0,0,35,8,0
山西,2020-02-13,0,3,0,35,11,0
山西,2020-02-15,0,1,0,35,12,0
山西,2020-02-16,1,1,0,36,13,0
山西,2020-02-17,0,2,0,36,15,0
山西,2020-02-19,0,3,0,36,18,0
山西,2020-02-20,0,3,0,36,21,0
山西,2020-02-22,0,1,0,36,22,0
山西,2020-02-23,0,1,0,36,23,0
山西,2020-02-24,1,0,0,37,23,0
山西,2020-02-25,0,2,0,37,25,0
山西,2020-02-27,0,1,0,37,26,0
山西,2020-02-28,0,1,0,37,27,0
山西,2020-02-29,0,1,0,37,28,0
山西,2020-03-01,0,1,0,37,29,0
山西,2020-03-03,0,3,0,37,32,0
山西,2020-03-09,0,1,0,37,33,0
山西,2020-03-10,0,3,0,37,36,0
山西,2020-03-13,0,1,0,37,37,0
四川,2020-01-25,1,0,0,1,0,0
四川,2020-01-27,1,0,0,2,0,0
四川,2020-02-06,1,0,0,3,0,0
四川,2020-02-13,0,2,0,3,2,0
四川,2020-02-24,0,1,0,3,3,0
浙江,2020-01-25,3,0,0,3,0,0
浙江,2020-01-27,2,0,0,5,0,0
浙江,2020-01-28,1,0,0,6,0,0
浙江,2020-01-29,0,1,0,6,1,0
浙江,2020-01-30,1,0,0,7,1,0
浙江,2020-01-31,1,0,0,8,1,0
浙江,2020-02-01,6,0,0,14,1,0
浙江,2020-02-02,2,0,0,16,1,0
浙江,2020-02-06,0,2,0,16,3,0
浙江,2020-02-07,1,0,0,17,3,0
浙江,2020-02-08,0,2,0,17,5,0
浙江,2020-02-11,0,2,0,17,7,0
浙江,2020-02-12,0,2,0,17,9,0
浙江,2020-02-14,0,1,0,17,10,0
浙江,2020-02-16,0,1,0,17,11,0
浙江,2020-02-19,0,3,0,17,14,0
浙江,2020-02-27,0,3,0,17,17,0
海南,2020-01-25,1,0,0,1,0,0
海南,2020-01-29,1,0,0,2,0,0
海南,2020-01-31,1,0,0,3,0,0
海南,2020-02-01,1,0,0,4,0,0
海南,2020-02-18,0,1,0,4,1,0
海南,2020-02-22,0,2,0,4,3,0
海南,2020-03-01,0,1,0,4,4,0
河南,2020-01-25,3,0,0,3,0,0
河南,2020-01-26,3,0,0,6,0,0
河南,2020-01-27,3,0,0,9,0,0
河南,2020-01-29,2,0,0,11,0,0
河南,2020-01-30,2,0,0,13,0,0
河南,2020-01-31,1,0,0,14,0,0
河南,2020-02-01,2,0,0,16,0,0
河南,2020-02-02,4,0,0,20,0,0
河南,2020-02-03,3,0,0,23,0,0
河南,2020-02-04,1,0,0,24,0,0
河南,2020-02-05,2,1,0,26,1,0
河南,2020-02-07,3,3,0,29,4,0
河南,2020-02-08,1,1,0,30,5,0
河南,2020-02-09,0,1,0,30,6,0
河南,2020-02-10,1,0,0,31,6,0
河南,2020-02-11,2,0,0,33,6,0
河南,2020-02-14,1,3,0,34,9,0
河南,2020-02-15,0,3,0,34,12,0
河南,2020-02-17,0,1,0,34,13,0
河南,2020-02-18,0,1,0,34,14,0
河南,2020-02-19,1,5,0,35,19,0
河南,2020-02-20,0,5,0,35,24,0
河南,2020-02-23,0,1,0,35,25,0
河南,2020-02-25,0,2,0,35,27,0
河南,2020-02-26,0,2,0,35,29,0
河南,2020-02-27,0,1,0,35,30,0
河南,2020-02-28,0,2,0,35,32,0
河南,2020-02-29,0,2,0,35,34,0
河南,2020-03-01,0,1,0,35,35,0
河南,2020-03-28,1,0,0,36,35,0
四川,2020-01-25,1,0,0,1,0,0
四川,2020-01-29,1,0,0,2,0,0
四川,2020-02-02,1,0,0,3,0,0
四川,2020-02-03,2,0,0,5,0,0
四川,2020-02-04,0,1,0,5,1,0
四川,2020-02-07,1,0,0,6,1,0
四川,2020-02-08,1,0,0,7,1,0
四川,2020-02-11,1,0,0,8,1,0
四川,2020-02-13,0,1,0,8,2,0
四川,2020-02-19,0,1,0,8,3,0
四川,2020-02-21,0,3,0,8,6,0
四川,2020-02-29,0,1,0,8,7,0
四川,2020-03-14,0,1,0,8,8,0
四川,2020-01-25,2,0,0,2,0,0
四川,2020-01-27,2,0,0,4,0,0
四川,2020-01-28,1,0,0,5,0,0
四川,2020-01-29,4,0,0,9,0,0
四川,2020-01-30,2,0,0,11,0,0
四川,2020-01-31,5,0,0,16,0,0
四川,2020-02-01,7,0,0,23,0,0
四川,2020-02-02,3,0,0,26,0,0
四川,2020-02-03,1,0,0,27,0,0
四川,2020-02-04,1,0,0,28,0,0
四川,2020-02-05,1,2,0,29,2,0
四川,2020-02-06,1,0,0,30,2,0
四川,2020-02-07,1,0,0,31,2,0
四川,2020-02-08,1,0,0,32,2,0
四川,2020-02-09,1,1,0,33,3,0
四川,2020-02-10,1,1,0,34,4,0
四川,2020-02-12,1,1,0,35,5,0
四川,2020-02-13,0,1,0,35,6,0
四川,2020-02-14,0,1,0,35,7,0
四川,2020-02-15,0,2,0,35,9,0
四川,2020-02-17,3,3,0,38,12,0
四川,2020-02-18,0,1,0,38,13,0
四川,2020-02-19,0,1,0,38,14,0
四川,2020-02-20,0,1,0,38,15,0
四川,2020-02-21,0,3,0,38,18,0
四川,2020-02-22,0,2,0,38,20,0
四川,2020-02-23,1,2,0,39,22,0
四川,2020-02-25,0,1,0,39,23,0
四川,2020-02-29,0,1,0,39,24,0
四川,2020-03-01,0,4,0,39,28,0
四川,2020-03-02,0,1,0,39,29,0
四川,2020-03-03,0,1,0,39,30,0
四川,2020-03-04,0,2,0,39,32,0
四川,2020-03-06,0,4,0,39,36,0
四川,2020-03-10,0,3,0,39,39,0
广西,2020-01-25,1,0,0,1,0,0
广西,2020-01-26,4,0,0,5,0,0
广西,2020-01-28,2,0,0,7,0,0
广西,2020-01-29,8,0,0,15,0,0
广西,2020-01-30,1,0,0,16,0,0
广西,2020-02-02,6,0,0,22,0,0
广西,2020-02-03,5,0,0,27,0,0
广西,2020-02-04,1,0,0,28,0,0
广西,2020-02-05,2,0,0,30,0,0
广西,2020-02-06,1,2,0,31,2,0
广西,2020-02-07,1,0,0,32,2,0
广西,2020-02-08,3,0,0,35,2,0
广西,2020-02-09,2,0,0,37,2,0
广西,2020-02-10,4,6,0,41,8,0
广西,2020-02-11,3,1,0,44,9,0
广西,2020-02-12,0,1,0,44,10,0
广西,2020-02-13,3,0,0,47,10,0
广西,2020-02-14,2,1,0,49,11,0
广西,2020-02-15,1,0,0,50,11,0
广西,2020-02-16,1,3,0,51,14,0
广西,2020-02-17,3,2,0,54,16,0
广西,2020-02-18,0,2,0,54,18,0
广西,2020-02-19,0,5,0,54,23,0
广西,2020-02-20,0,1,0,54,24,0
广西,2020-02-21,1,1,0,55,25,0
广西,2020-02-22,0,3,0,55,28,0
广西,2020-02-23,0,1,0,55,29,0
广西,2020-02-24,0,5,0,55,34,0
广西,2020-02-25,0,2,0,55,36,0
广西,2020-02-26,0,6,0,55,42,0
广西,2020-02-27,0,2,0,55,44,0
广西,2020-02-28,0,2,0,55,46,0
广西,2020-02-29,0,4,0,55,50,0
广西,2020-03-01,0,2,0,55,52,0
广西,2020-03-02,0,2,0,55,54,0
广西,2020-03-15,0,1,0,55,55,0
黑龙江,2020-01-25,1,0,0,1,0,0
黑龙江,2020-01-27,1,0,0,2,0,0
黑龙江,2020-01-28,1,0,0,3,0,0
黑龙江,2020-02-03,3,0,0,6,0,0
黑龙江,2020-02-04,14,0,0,20,0,0
黑龙江,2020-02-05,6,0,0,26,0,0
黑龙江,2020-02-06,1,0,0,27,0,0
黑龙江,2020-02-09,3,0,1,30,0,1
黑龙江,2020-02-10,2,0,0,32,0,1
黑龙江,2020-02-11,1,1,0,33,1,1
黑龙江,2020-02-12,0,3,0,33,4,1
黑龙江,2020-02-13,3,4,0,36,8,1
黑龙江,2020-02-15,2,0,0,38,8,1
黑龙江,2020-02-16,4,2,0,42,10,1
黑龙江,2020-02-17,1,0,0,43,10,1
黑龙江,2020-02-19,0,1,0,43,11,1
黑龙江,2020-02-20,0,5,0,43,16,1
黑龙江,2020-02-21,0,6,0,43,22,1
黑龙江,2020-02-22,0,1,0,43,23,1
黑龙江,2020-02-23,0,1,0,43,24,1
黑龙江,2020-02-24,0,2,0,43,26,1
黑龙江,2020-02-26,0,2,0,43,28,1
黑龙江,2020-02-27,0,5,0,43,33,1
黑龙江,2020-03-02,0,2,0,43,35,1
黑龙江,2020-03-03,0,1,0,43,36,1
黑龙江,2020-03-08,0,2,0,43,38,1
黑龙江,2020-03-09,0,2,0,43,40,1
黑龙江,2020-03-18,0,1,0,43,41,1
黑龙江,2020-03-25,0,1,0,43,42,1
贵州,2020-01-25,1,0,0,1,0,0
贵州,2020-02-03,1,0,0,2,0,0
贵州,2020-02-04,1,0,0,3,0,0
贵州,2020-02-07,1,0,0,4,0,0
贵州,2020-02-11,0,1,0,4,1,0
贵州,2020-02-12,0,2,0,4,3,0
贵州,2020-02-14,0,1,0,4,4,0
云南,2020-01-25,1,0,0,1,0,0
云南,2020-01-27,1,0,0,2,0,0
云南,2020-01-28,3,0,0,5,0,0
云南,2020-02-02,1,1,0,6,1,0
云南,2020-02-03,2,0,0,8,1,0
云南,2020-02-04,2,0,0,10,1,0
云南,2020-02-07,1,0,0,11,1,0
云南,2020-02-10,1,0,0,12,1,0
云南,2020-02-11,1,0,0,13,1,0
云南,2020-02-14,0,4,0,13,5,0
云南,2020-02-17,0,1,0,13,6,0
云南,2020-02-21,0,2,0,13,8,0
云南,2020-02-23,0,1,0,13,9,0
云南,2020-02-25,0,1,0,13,10,0
云南,2020-02-27,0,2,0,13,12,0
云南,2020-03-14,0,1,0,13,13,0
福建,2020-01-25,1,0,0,1,0,0
福建,2020-01-26,3,0,0,4,0,0
福建,2020-01-28,4,0,0,8,0,0
福建,2020-01-29,2,0,0,10,0,0
福建,2020-02-01,1,0,0,11,0,0
福建,2020-02-06,1,0,0,12,0,0
福建,2020-02-08,1,1,0,13,1,0
福建,2020-02-14,0,2,0,13,3,0
福建,2020-02-16,1,0,0,14,3,0
福建,2020-02-19,0,2,0,14,5,0
福建,2020-02-25,0,3,0,14,8,0
福建,2020-02-28,0,4,0,14,12,0
福建,2020-03-05,0,2,0,14,14,0
江苏,2020-01-25,1,0,0,1,0,0
江苏,2020-01-26,1,0,0,2,0,0
江苏,2020-01-27,2,0,0,4,0,0
江苏,2020-01-28,4,0,0,8,0,0
江苏,2020-01-29,1,0,0,9,0,0
江苏,2020-01-30,3,0,0,12,0,0
江苏,2020-01-31,5,0,0,17,0,0
江苏,2020-02-02,4,0,0,21,0,0
江苏,2020-02-03,2,0,0,23,0,0
江苏,2020-02-04,3,1,0,26,1,0
江苏,2020-02-05,2,0,0,28,1,0
江苏,2020-02-06,1,2,0,29,3,0
江苏,2020-02-07,1,0,0,30,3,0
江苏,2020-02-08,0,1,0,30,4,0
江苏,2020-02-09,1,1,0,31,5,0
江苏,2020-02-10,3,0,0,34,5,0
江苏,2020-02-11,2,1,0,36,6,0
江苏,2020-02-12,1,9,0,37,15,0
江苏,2020-02-14,0,1,0,37,16,0
江苏,2020-02-16,0,4,0,37,20,0
江苏,2020-02-17,0,1,0,37,21,0
江苏,2020-02-18,0,1,0,37,22,0
江苏,2020-02-19,0,2,0,37,24,0
江苏,2020-02-21,0,1,0,37,25,0
江苏,2020-02-23,0,1,0,37,26,0
江苏,2020-02-24,0,2,0,37,28,0
江苏,2020-02-26,0,4,0,37,32,0
江苏,2020-02-27,0,5,0,37,37,0
重庆,2020-01-25,1,0,0,1,0,0
重庆,2020-01-27,1,0,0,2,0,0
重庆,2020-02-01,2,0,0,4,0,0
重庆,2020-02-02,3,0,0,7,0,0
重庆,2020-02-08,1,0,0,8,0,0
重庆,2020-02-13,0,1,0,8,1,0
重庆,2020-02-14,1,0,0,9,1,0
重庆,2020-02-15,0,1,0,9,2,0
重庆,2020-02-16,0,1,0,9,3,0
重庆,2020-02-18,0,1,0,9,4,0
重庆,2020-02-20,1,0,0,10,4,0
重庆,2020-02-28,0,3,0,10,7,0
重庆,2020-03-03,0,1,0,10,8,0
重庆,2020-03-09,0,1,0,10,9,0
重庆,2020-03-12,0,1,0,10,10,0
天津,2020-01-25,1,0,0,1,0,0
天津,2020-01-26,1,0,0,2,0,0
天津,2020-01-29,2,0,0,4,0,0
天津,2020-02-03,2,0,0,6,0,0
天津,2020-02-10,0,1,0,6,1,0
天津,2020-02-15,0,1,0,6,2,0
天津,2020-02-16,0,1,0,6,3,0
天津,2020-02-19,0,1,0,6,4,0
天津,2020-02-23,0,1,0,6,5,0
天津,2020-02-27,0,1,0,6,6,0
青海,2020-01-25,1,0,0,1,0,0
青海,2020-01-26,3,0,0,4,0,0
青海,2020-01-27,2,0,0,6,0,0
青海,2020-01-30,2,0,0,8,0,0
青海,2020-01-31,1,0,0,9,0,0
青海,2020-02-02,3,0,0,12,0,0
青海,2020-02-04,2,0,0,14,0,0
青海,2020-02-05,1,3,0,15,3,0
青海,2020-02-11,0,2,0,15,5,0
青海,2020-02-12,0,4,0,15,9,0
青海,2020-02-15,0,2,0,15,11,0
青海,2020-02-18,0,2,0,15,13,0
青海,2020-02-19,0,1,0,15,14,0
青海,2020-02-21,0,1,0,15,15,0
湖北,2020-01-25,43,0,0,43,0,0
湖北,2020-01-26,21,0,0,64,0,0
湖北,2020-01-27,27,0,0,91,0,0
湖北,2020-01-28,21,0,0,112,0,0
湖北,2020-01-29,18,0,0,130,0,0
湖北,2020-01-30,36,0,0,166,0,0
湖北,2020-01-31,40,1,0,206,1,0
湖北,2020-02-01,40,0,0,246,1,0
湖北,2020-02-02,50,0,0,296,1,0
湖北,2020-02-03,52,0,0,348,1,0
湖北,2020-02-04,36,1,0,384,2,0
湖北,2020-02-05,15,1,1,399,3,1
湖北,2020-02-06,44,3,0,443,6,1
湖北,2020-02-07,33,6,1,476,12,2
湖北,2020-02-08,17,11,2,493,23,4
湖北,2020-02-09,14,21,0,507,44,4
湖北,2020-02-10,8,7,1,515,51,5
湖北,2020-02-11,9,14,1,524,65,6
湖北,2020-02-12,8,19,1,532,84,7
湖北,2020-02-13,172,15,1,704,99,8
湖北,2020-02-14,100,28,0,804,127,8
湖北,2020-02-15,12,25,0,816,152,8
湖北,2020-02-16,9,29,2,825,181,10
湖北,2020-02-17,7,23,0,832,204,10
湖北,2020-02-18,0,21,0,832,225,10
湖北,2020-02-19,2,43,0,834,268,10
湖北,2020-02-20,0,45,0,834,313,10
湖北,2020-02-21,2,45,1,836,358,11
湖北,2020-02-22,0,40,0,836,398,11
湖北,2020-02-23,0,47,0,836,445,11
湖北,2020-02-24,0,59,0,836,504,11
湖北,2020-02-25,0,56,0,836,560,11
湖北,2020-02-26,0,47,0,836,607,11
湖北,2020-02-27,0,37,0,836,644,11
湖北,2020-02-28,0,33,0,836,677,11
湖北,2020-02-29,0,15,1,836,692,12
湖北,2020-03-01,0,38,0,836,730,12
湖北,2020-03-02,0,19,0,836,749,12
湖北,2020-03-03,0,10,2,836,759,14
湖北,2020-03-04,0,17,0,836,776,14
湖北,2020-03-05,0,10,0,836,786,14
湖北,2020-03-06,0,8,0,836,794,14
湖北,2020-03-07,0,7,0,836,801,14
湖北,2020-03-08,0,5,0,836,806,14
湖北,2020-03-09,0,2,0,836,808,14
湖北,2020-03-10,0,4,0,836,812,14
湖北,2020-03-12,0,4,0,836,816,14
湖北,2020-03-13,0,2,0,836,818,14
湖北,2020-03-14,0,1,0,836,819,14
湖北,2020-03-16,0,1,1,836,820,15
湖北,2020-03-17,0,1,0,836,821,15
湖南,2020-01-25,3,0,0,3,0,0
湖南,2020-01-29,1,0,0,4,0,0
湖南,2020-01-30,1,0,0,5,0,0
湖南,2020-01-31,1,0,0,6,0,0
湖南,2020-02-02,0,1,0,6,1,0
湖南,2020-02-04,1,0,0,7,1,0
湖南,2020-02-06,1,0,0,8,1,0
湖南,2020-02-08,0,2,0,8,3,0
湖南,2020-02-09,0,1,0,8,4,0
湖南,2020-02-10,0,2,0,8,6,0
湖南,2020-02-18,0,1,0,8,7,0
湖南,2020-02-21,0,1,0,8,8,0
湖北,2020-01-25,2,0,0,2,0,0
湖北,2020-01-26,34,0,0,36,0,0
湖北,2020-01-27,34,0,0,70,0,0
湖北,2020-01-28,61,0,0,131,0,0
湖北,2020-01-29,32,0,0,163,0,0
湖北,2020-01-30,123,0,0,286,0,0
湖北,2020-01-31,61,0,0,347,0,0
湖北,2020-02-01,94,0,0,441,0,0
湖北,2020-02-02,107,0,0,548,0,0
湖北,2020-02-03,84,0,1,632,0,1
湖北,2020-02-04,103,6,1,735,6,2
湖北,2020-02-05,52,3,0,787,9,2
湖北,2020-02-06,51,19,1,838,28,3
湖北,2020-02-07,59,2,2,897,30,5
湖北,2020-02-08,71,9,2,968,39,7
湖北,2020-02-09,51,2,2,1019,41,9
湖北,2020-02-10,44,7,3,1063,48,12
湖北,2020-02-11,25,11,0,1088,59,12
湖北,2020-02-12,13,6,1,1101,65,13
湖北,2020-02-13,10,7,3,1111,72,16
湖北,2020-02-14,17,12,2,1128,84,18
湖北,2020-02-15,16,29,1,1144,113,19
湖北,2020-02-16,11,37,1,1155,150,20
湖北,2020-02-17,8,31,1,1163,181,21
湖北,2020-02-18,2,48,1,1165,229,22
湖北,2020-02-19,3,64,1,1168,293,23
湖北,2020-02-20,3,50,1,1171,343,24
湖北,2020-02-21,2,59,2,1173,402,26
湖北,2020-02-22,0,61,2,1173,463,28
湖北,2020-02-23,1,58,1,1174,521,29
湖北,2020-02-24,1,72,1,1175,593,30
湖北,2020-02-25,0,60,0,1175,653,30
湖北,2020-02-26,0,48,1,1175,701,31
湖北,2020-02-27,0,52,1,1175,753,32
湖北,2020-02-28,0,49,1,1175,802,33
湖北,2020-02-29,0,48,1,1175,850,34
湖北,2020-03-01,0,35,0,1175,885,34
湖北,2020-03-02,0,28,0,1175,913,34
湖北,2020-03-03,0,27,0,1175,940,34
湖北,2020-03-04,0,40,1,1175,980,35
湖北,2020-03-05,0,31,0,1175,1011,35
湖北,2020-03-06,0,29,1,1175,1040,36
湖北,2020-03-07,0,15,2,1175,1055,38
湖北,2020-03-08,0,9,0,1175,1064,38
湖北,2020-03-09,0,8,0,1175,1072,38
湖北,2020-03-10,0,22,0,1175,1094,38
湖北,2020-03-11,0,11,0,1175,1105,38
湖北,2020-03-12,0,7,0,1175,1112,38
湖北,2020-03-13,0,3,0,1175,1115,38
湖北,2020-03-14,0,10,0,1175,1125,38
湖北,2020-03-15,0,3,0,1175,1128,38
湖北,2020-03-16,0,1,0,1175,1129,38
湖北,2020-03-17,0,2,0,1175,1131,38
湖北,2020-03-18,0,0,1,1175,1131,39
湖北,2020-03-22,0,3,0,1175,1134,39
湖北,2020-03-26,0,1,0,1175,1135,39
湖北,2020-04-10,0,0,1,1175,1135,40
安徽,2020-01-25,2,0,0,2,0,0
安徽,2020-01-26,1,0,0,3,0,0
安徽,2020-01-28,6,0,0,9,0,0
安徽,2020-01-29,1,0,0,10,0,0
安徽,2020-01-31,2,0,0,12,0,0
安徽,2020-02-01,2,0,0,14,0,0
安徽,2020-02-02,7,0,0,21,0,0
安徽,2020-02-03,2,0,0,23,0,0
安徽,2020-02-04,1,0,0,24,0,0
安徽,2020-02-05,1,0,0,25,0,0
安徽,2020-02-06,2,0,0,27,0,0
安徽,2020-02-07,1,0,0,28,0,0
安徽,2020-02-08,0,1,0,28,1,0
安徽,2020-02-09,3,2,0,31,3,0
安徽,2020-02-10,2,0,0,33,3,0
安徽,2020-02-11,3,1,0,36,4,0
安徽,2020-02-12,2,4,0,38,8,0
安徽,2020-02-13,1,2,0,39,10,0
安徽,2020-02-14,0,1,0,39,11,0
安徽,2020-02-16,1,2,0,40,13,0
安徽,2020-02-17,1,3,0,41,16,0
安徽,2020-02-18,0,1,0,41,17,0
安徽,2020-02-19,0,3,0,41,20,0
安徽,2020-02-20,0,2,0,41,22,0
安徽,2020-02-21,0,1,0,41,23,0
安徽,2020-02-22,0,3,0,41,26,0
安徽,2020-02-24,0,3,0,41,29,0
安徽,2020-02-26,0,1,0,41,30,0
安徽,2020-02-27,0,3,0,41,33,0
安徽,2020-02-28,0,1,0,41,34,0
安徽,2020-02-29,0,2,0,41,36,0
安徽,2020-03-01,0,1,0,41,37,0
安徽,2020-03-03,0,1,0,41,38,0
安徽,2020-03-04,0,3,0,41,41,0
安徽,2020-01-25,1,0,0,1,0,0
安徽,2020-01-27,1,0,0,2,0,0
安徽,2020-01-29,2,0,0,4,0,0
安徽,2020-02-02,0,1,0,4,1,0
安徽,2020-02-05,1,0,0,5,1,0
安徽,2020-02-06,0,1,0,5,2,0
安徽,2020-02-09,1,0,0,6,2,0
安徽,2020-02-11,0,2,0,6,4,0
安徽,2020-03-04,0,1,0,6,5,0
安徽,2020-03-05,0,1,0,6,6,0
新疆,2020-01-25,1,0,0,1,0,0
新疆,2020-01-27,1,0,0,2,0,0
新疆,2020-01-28,2,0,0,4,0,0
新疆,2020-01-30,1,0,0,5,0,0
新疆,2020-02-02,1,0,0,6,0,0
新疆,2020-02-03,1,0,0,7,0,0
新疆,2020-02-04,2,0,0,9,0,0
新疆,2020-02-08,1,0,0,10,0,0
新疆,2020-02-11,2,0,0,12,0,0
新疆,2020-02-12,2,0,0,14,0,0
新疆,2020-02-13,0,1,0,14,1,0
新疆,2020-02-14,2,0,0,16,1,0
新疆,2020-02-15,0,3,0,16,4,0
新疆,2020-02-16,2,0,0,18,4,0
新疆,2020-02-19,0,2,0,18,6,0
新疆,2020-02-26,0,2,0,18,8,0
新疆,2020-02-27,0,2,0,18,10,0
新疆,2020-02-28,0,2,0,18,12,0
新疆,2020-02-29,0,6,0,18,18,0
辽宁,2020-01-25,1,0,0,1,0,0
辽宁,2020-02-11,0,1,0,1,1,0
云南,2020-01-25,1,0,0,1,0,0
云南,2020-01-27,4,0,0,5,0,0
云南,2020-01-29,1,0,0,6,0,0
云南,2020-01-31,1,0,0,7,0,0
云南,2020-02-01,4,0,0,11,0,0
云南,2020-02-02,1,0,0,12,0,0
云南,2020-02-03,0,1,0,12,1,0
云南,2020-02-05,1,0,0,13,1,0
云南,2020-02-07,1,1,0,14,2,0
云南,2020-02-11,0,1,0,14,3,0
云南,2020-02-19,0,0,1,14,3,1
云南,2020-02-20,0,6,0,14,9,1
云南,2020-02-24,0,3,0,14,12,1
云南,2020-03-02,0,1,0,14,13,1
福建,2020-01-25,3,0,0,3,0,0
福建,2020-01-26,1,0,0,4,0,0
福建,2020-01-27,1,0,0,5,0,0
福建,2020-01-28,1,0,0,6,0,0
福建,2020-01-29,1,0,0,7,0,0
福建,2020-01-30,1,0,0,8,0,0
福建,2020-01-31,3,0,0,11,0,0
福建,2020-02-01,1,0,0,12,0,0
福建,2020-02-02,1,0,0,13,0,0
福建,2020-02-04,2,0,0,15,0,0
福建,2020-02-05,1,0,0,16,0,0
福建,2020-02-06,0,1,0,16,1,0
福建,2020-02-09,0,2,0,16,3,0
福建,2020-02-10,1,0,0,17,3,0
福建,2020-02-11,2,0,0,19,3,0
福建,2020-02-12,0,1,0,19,4,0
福建,2020-02-14,1,1,0,20,5,0
福建,2020-02-15,0,1,0,20,6,0
福建,2020-02-16,0,2,0,20,8,0
福建,2020-02-18,0,2,0,20,10,0
福建,2020-02-19,0,1,0,20,11,0
福建,2020-02-20,0,2,0,20,13,0
福建,2020-02-21,0,1,0,20,14,0
福建,2020-02-25,0,1,0,20,15,0
福建,2020-02-28,0,1,0,20,16,0
福建,2020-03-07,0,4,0,20,20,0
山东,2020-01-25,1,0,0,1,0,0
山东,2020-01-26,1,0,0,2,0,0
山东,2020-01-28,2,0,0,4,0,0
山东,2020-01-29,2,0,0,6,0,0
山东,2020-01-30,2,0,0,8,0,0
山东,2020-01-31,2,0,0,10,0,0
山东,2020-02-01,2,0,0,12,0,0
山东,2020-02-04,2,0,0,14,0,0
山东,2020-02-06,1,0,0,15,0,0
山东,2020-02-07,0,1,0,15,1,0
山东,2020-02-08,1,0,0,16,1,0
山东,2020-02-10,3,0,0,19,1,0
山东,2020-02-11,1,0,0,20,1,0
山东,2020-02-12,3,0,0,23,1,0
山东,2020-02-13,3,0,0,26,1,0
山东,2020-02-14,2,3,0,28,4,0
山东,2020-02-15,1,0,0,29,4,0
山东,2020-02-17,0,1,0,29,5,0
山东,2020-02-18,0,1,0,29,6,0
山东,2020-02-20,0,3,0,29,9,0
山东,2020-02-21,1,1,0,30,10,0
山东,2020-02-22,0,4,0,30,14,0
山东,2020-02-24,0,2,1,30,16,1
山东,2020-02-26,0,2,0,30,18,1
山东,2020-02-28,0,3,0,30,21,1
山东,2020-03-03,0,2,0,30,23,1
山东,2020-03-04,0,1,0,30,24,1
山东,2020-03-07,0,1,0,30,25,1
山东,2020-03-09,0,1,0,30,26,1
山东,2020-03-10,0,2,0,30,28,1
山东,2020-03-16,0,1,0,30,29,1
重庆,2020-01-26,1,0,0,1,0,0
重庆,2020-02-02,1,0,0,2,0,0
重庆,2020-02-03,1,0,0,3,0,0
重庆,2020-02-09,0,1,0,3,1,0
重庆,2020-02-10,2,0,0,5,1,0
重庆,2020-02-13,1,0,0,6,1,0
重庆,2020-02-17,0,1,0,6,2,0
重庆,2020-02-22,0,1,0,6,3,0
重庆,2020-02-29,0,1,0,6,4,0
重庆,2020-03-09,0,1,0,6,5,0
重庆,2020-03-10,0,1,0,6,6,0
内蒙古,2020-01-26,2,0,0,2,0,0
内蒙古,2020-01-27,1,0,0,3,0,0
内蒙古,2020-02-01,2,0,0,5,0,0
内蒙古,2020-02-02,1,0,0,6,0,0
内蒙古,2020-02-04,1,0,0,7,0,0
内蒙古,2020-02-05,2,0,0,9,0,0
内蒙古,2020-02-07,1,0,0,10,0,0
内蒙古,2020-02-09,1,0,0,11,0,0
内蒙古,2020-02-19,0,1,0,11,1,0
内蒙古,2020-02-20,0,1,0,11,2,0
内蒙古,2020-02-22,0,2,0,11,4,0
内蒙古,2020-02-24,0,1,0,11,5,0
内蒙古,2020-02-28,0,1,0,11,6,0
内蒙古,2020-03-02,0,2,0,11,8,0
内蒙古,2020-03-07,0,1,0,11,9,0
内蒙古,2020-03-16,0,1,0,11,10,0
内蒙古,2020-03-18,0,1,0,11,11,0
云南,2020-01-26,2,0,0,2,0,0
云南,2020-01-27,2,0,0,4,0,0
云南,2020-01-29,1,0,0,5,0,0
云南,2020-01-30,1,0,0,6,0,0
云南,2020-01-31,1,0,0,7,0,0
云南,2020-02-01,1,0,0,8,0,0
云南,2020-02-06,1,0,0,9,0,0
云南,2020-02-15,0,2,0,9,2,0
云南,2020-02-19,0,1,0,9,3,0
云南,2020-02-21,0,1,0,9,4,0
云南,2020-02-22,0,1,0,9,5,0
云南,2020-02-25,0,2,0,9,7,0
云南,2020-02-26,0,1,0,9,8,0
云南,2020-03-03,0,1,0,9,9,0
辽宁,2020-01-26,1,0,0,1,0,0
辽宁,2020-01-27,4,0,0,5,0,0
辽宁,2020-02-01,1,0,0,6,0,0
辽宁,2020-02-05,1,0,0,7,0,0
辽宁,2020-02-06,0,1,0,7,1,0
辽宁,2020-02-09,0,2,0,7,3,0
辽宁,2020-02-13,0,1,0,7,4,0
辽宁,2020-02-19,0,1,0,7,5,0
辽宁,2020-02-21,0,1,0,7,6,0
辽宁,2020-02-29,1,0,0,8,6,0
辽宁,2020-03-01,0,1,0,8,7,0
辽宁,2020-03-02,3,0,0,11,7,0
辽宁,2020-03-16,0,2,0,11,9,0
辽宁,2020-03-17,0,2,0,11,11,0
云南,2020-01-26,2,0,0,2,0,0
云南,2020-01-30,1,0,0,3,0,0
云南,2020-02-02,1,0,0,4,0,0
云南,2020-02-03,1,0,0,5,0,0
云南,2020-02-13,0,2,0,5,2,0
云南,2020-02-26,0,2,0,5,4,0
云南,2020-03-14,0,1,0,5,5,0
河南,2020-01-26,2,0,0,2,0,0
河南,2020-01-28,3,0,0,5,0,0
河南,2020-01-29,1,0,0,6,0,0
河南,2020-02-01,2,0,0,8,0,0
河南,2020-02-03,2,0,0,10,0,0
河南,2020-02-06,1,0,0,11,0,0
河南,2020-02-07,2,0,0,13,0,0
河南,2020-02-08,4,0,0,17,0,0
河南,2020-02-10,1,3,0,18,3,0
河南,2020-02-11,1,0,0,19,3,0
河南,2020-02-16,0,1,0,19,4,0
河南,2020-02-19,0,3,0,19,7,0
河南,2020-02-20,0,3,0,19,10,0
河南,2020-02-23,0,1,0,19,11,0
河南,2020-02-24,0,1,0,19,12,0
河南,2020-02-25,0,2,0,19,14,0
河南,2020-02-26,0,2,0,19,16,0
河南,2020-02-28,0,2,0,19,18,0
河南,2020-02-29,0,1,0,19,19,0
黑龙江,2020-01-26,1,0,0,1,0,0
黑龙江,2020-01-28,4,0,0,5,0,0
黑龙江,2020-01-30,3,0,0,8,0,0
黑龙江,2020-01-31,3,0,0,11,0,0
黑龙江,2020-02-05,1,0,0,12,0,0
黑龙江,2020-02-06,1,1,0,13,1,0
黑龙江,2020-02-09,1,0,0,14,1,0
黑龙江,2020-02-10,1,4,0,15,5,0
黑龙江,2020-02-14,0,2,0,15,7,0
黑龙江,2020-02-15,0,2,0,15,9,0
黑龙江,2020-02-16,0,2,0,15,11,0
黑龙江,2020-02-18,0,1,0,15,12,0
黑龙江,2020-02-19,0,2,0,15,14,0
黑龙江,2020-02-21,0,1,0,15,15,0
重庆,2020-01-26,2,0,0,2,0,0
重庆,2020-01-29,1,0,0,3,0,0
重庆,2020-02-05,1,0,0,4,0,0
重庆,2020-02-07,0,1,0,4,1,0
重庆,2020-02-14,0,1,0,4,2,0
重庆,2020-02-17,0,1,0,4,3,0
重庆,2020-02-23,0,1,0,4,4,0
河南,2020-01-26,1,0,0,1,0,0
河南,2020-01-27,1,0,0,2,0,0
河南,2020-01-28,1,0,0,3,0,0
河南,2020-01-29,1,0,0,4,0,0
河南,2020-01-30,2,0,0,6,0,0
河南,2020-01-31,2,0,0,8,0,0
河南,2020-02-01,3,0,0,11,0,0
河南,2020-02-03,1,0,0,12,0,0
河南,2020-02-04,5,0,0,17,0,0
河南,2020-02-05,1,0,0,18,0,0
河南,2020-02-06,2,0,0,20,0,0
河南,2020-02-07,1,0,0,21,0,0
河南,2020-02-08,3,0,0,24,0,0
河南,2020-02-10,1,0,0,25,0,0
河南,2020-02-15,1,0,0,26,0,0
河南,2020-02-20,0,2,0,26,2,0
河南,2020-02-21,0,1,0,26,3,0
河南,2020-02-22,0,5,0,26,8,0
河南,2020-02-23,0,5,0,26,13,0
河南,2020-02-24,0,3,0,26,16,0
河南,2020-02-26,0,1,0,26,17,0
河南,2020-02-27,0,1,0,26,18,0
河北,2020-01-26,2,0,0,2,0,0
河北,2020-01-27,4,0,0,6,0,0
河北,2020-01-28,3,0,0,9,0,0
河北,2020-01-31,2,0,0,11,0,0
河北,2020-02-01,0,1,0,11,1,0
河北,2020-02-02,1,0,0,12,1,0
河北,2020-02-04,1,0,0,13,1,0
河北,2020-02-05,1,0,0,14,1,0
河北,2020-02-06,1,3,0,15,4,0
河北,2020-02-07,5,0,0,20,4,0
河北,2020-02-08,2,0,0,22,4,0
河北,2020-02-09,2,1,0,24,5,0
河北,2020-02-10,2,0,0,26,5,0
河北,2020-02-11,2,3,0,28,8,0
河北,2020-02-12,1,0,0,29,8,0
河北,2020-02-13,0,4,0,29,12,0
河北,2020-02-15,1,2,0,30,14,0
河北,2020-02-17,0,2,0,30,16,0
河北,2020-02-18,0,2,0,30,18,0
河北,2020-02-19,0,2,0,30,20,0
河北,2020-02-20,0,1,0,30,21,0
河北,2020-02-21,0,1,0,30,22,0
河北,2020-02-22,0,3,0,30,25,0
河北,2020-02-23,0,2,0,30,27,0
河北,2020-02-24,0,1,0,30,28,0
河北,2020-02-26,0,2,0,30,30,0
河北,2020-06-23,2,0,0,32,30,0
四川,2020-01-26,1,0,0,1,0,0
四川,2020-01-27,1,0,0,2,0,0
四川,2020-01-30,1,0,0,3,0,0
四川,2020-01-31,2,0,0,5,0,0
四川,2020-02-02,1,0,0,6,0,0
四川,2020-02-04,1,0,0,7,0,0
四川,2020-02-07,2,0,0,9,0,0
四川,2020-02-09,1,1,0,10,1,0
四川,2020-02-13,0,2,0,10,3,0
四川,2020-02-14,1,1,0,11,4,0
四川,2020-02-15,2,1,0,13,5,0
四川,2020-02-20,0,1,0,13,6,0
四川,2020-02-22,0,2,0,13,8,0
四川,2020-02-25,0,1,0,13,9,0
四川,2020-02-28,0,1,0,13,10,0
四川,2020-03-02,0,2,0,13,12,0
四川,2020-03-06,0,1,0,13,13,0
山西,2020-01-26,1,0,0,1,0,0
山西,2020-02-05,0,1,0,1,1,0
山西,2020-02-06,1,0,0,2,1,0
山西,2020-02-24,0,1,0,2,2,0
贵州,2020-01-26,1,0,0,1,0,0
贵州,2020-01-30,3,0,0,4,0,0
贵州,2020-01-31,4,0,0,8,0,0
贵州,2020-02-02,1,0,0,9,0,0
贵州,2020-02-05,0,0,1,9,0,1
贵州,2020-02-08,1,0,0,10,0,1
贵州,2020-02-11,0,1,0,10,1,1
贵州,2020-02-13,0,2,0,10,3,1
贵州,2020-02-17,0,3,0,10,6,1
贵州,2020-02-22,0,1,0,10,7,1
贵州,2020-02-23,0,1,0,10,8,1
贵州,2020-03-13,0,1,0,10,9,1
甘肃,2020-01-26,1,0,0,1,0,0
甘肃,2020-01-30,2,0,0,3,0,0
甘肃,2020-02-02,1,0,0,4,0,0
甘肃,2020-02-12,0,1,0,4,1,0
甘肃,2020-02-14,0,2,0,4,3,0
甘肃,2020-02-18,0,1,0,4,4,0
山西,2020-01-26,1,0,0,1,0,0
山西,2020-01-27,2,0,0,3,0,0
山西,2020-01-29,1,0,0,4,0,0
山西,2020-01-30,1,0,0,5,0,0
山西,2020-02-05,1,1,0,6,1,0
山西,2020-02-06,0,2,0,6,3,0
山西,2020-02-11,0,2,0,6,5,0
山西,2020-02-15,0,1,0,6,6,0
广东,2020-01-26,1,0,0,1,0,0
广东,2020-01-27,2,0,0,3,0,0
广东,2020-01-28,1,0,0,4,0,0
广东,2020-01-29,1,0,0,5,0,0
广东,2020-02-01,1,0,0,6,0,0
广东,2020-02-02,1,0,0,7,0,0
广东,2020-02-03,2,0,0,9,0,0
广东,2020-02-04,1,0,0,10,0,0
广东,2020-02-05,2,0,0,12,0,0
广东,2020-02-07,1,4,0,13,4,0
广东,2020-02-12,0,1,0,13,5,0
广东,2020-02-13,1,0,0,14,5,0
广东,2020-02-14,1,2,0,15,7,0
广东,2020-02-15,1,0,0,16,7,0
广东,2020-02-17,0,1,0,16,8,0
广东,2020-02-19,0,2,0,16,10,0
广东,2020-02-21,0,1,0,16,11,0
广东,2020-02-26,0,1,0,16,12,0
广东,2020-03-04,0,1,0,16,13,0
广东,2020-03-06,0,2,0,16,15,0
广东,2020-03-12,0,1,0,16,16,0
福建,2020-01-26,1,0,0,1,0,0
福建,2020-01-27,1,0,0,2,0,0
福建,2020-01-28,1,0,0,3,0,0
福建,2020-01-31,5,0,0,8,0,0
福建,2020-02-02,3,0,0,11,0,0
福建,2020-02-04,1,0,0,12,0,0
福建,2020-02-07,2,1,0,14,1,0
福建,2020-02-08,2,0,0,16,1,0
福建,2020-02-09,2,1,0,18,2,0
福建,2020-02-10,1,0,0,19,2,0
福建,2020-02-11,0,1,0,19,3,0
福建,2020-02-12,1,0,0,20,3,0
福建,2020-02-14,0,1,0,20,4,0
福建,2020-02-15,0,1,0,20,5,0
福建,2020-02-16,0,2,0,20,7,0
福建,2020-02-17,0,1,0,20,8,0
福建,2020-02-22,0,2,0,20,10,0
福建,2020-02-25,0,2,0,20,12,0
福建,2020-02-27,0,1,0,20,13,0
福建,2020-02-28,0,1,0,20,14,0
福建,2020-03-01,0,1,0,20,15,0
福建,2020-03-03,0,2,0,20,17,0
福建,2020-03-04,0,1,0,20,18,0
福建,2020-03-05,0,2,0,20,20,0
辽宁,2020-01-26,2,0,0,2,0,0
辽宁,2020-01-29,1,0,0,3,0,0
辽宁,2020-01-31,4,0,0,7,0,0
辽宁,2020-02-02,1,0,0,8,0,0
辽宁,2020-02-06,3,0,0,11,0,0
辽宁,2020-02-16,0,2,0,11,2,0
辽宁,2020-02-17,0,2,0,11,4,0
辽宁,2020-02-20,0,1,0,11,5,0
辽宁,2020-02-23,0,2,0,11,7,0
辽宁,2020-02-24,0,2,0,11,9,0
辽宁,2020-02-26,0,1,0,11,10,0
辽宁,2020-02-27,0,1,0,11,11,0
福建,2020-01-26,1,0,0,1,0,0
福建,2020-01-27,9,0,0,10,0,0
福建,2020-01-28,4,0,0,14,0,0
福建,2020-01-29,3,0,0,17,0,0
福建,2020-01-30,5,0,0,22,0,0
福建,2020-01-31,3,0,0,25,0,0
福建,2020-02-01,2,0,0,27,0,0
福建,2020-02-02,7,0,0,34,0,0
福建,2020-02-03,3,1,0,37,1,0
福建,2020-02-04,1,0,0,38,1,0
福建,2020-02-05,4,0,0,42,1,0
福建,2020-02-06,2,0,0,44,1,0
福建,2020-02-07,3,0,0,47,1,0
福建,2020-02-09,4,0,0,51,1,0
福建,2020-02-10,0,1,0,51,2,0
福建,2020-02-11,1,4,0,52,6,0
福建,2020-02-12,2,2,0,54,8,0
福建,2020-02-13,0,2,0,54,10,0
福建,2020-02-14,1,2,0,55,12,0
福建,2020-02-15,0,5,0,55,17,0
福建,2020-02-19,0,2,0,55,19,0
福建,2020-02-20,0,3,0,55,22,0
福建,2020-02-22,0,2,0,55,24,0
福建,2020-02-24,0,6,0,55,30,0
福建,2020-02-25,0,1,0,55,31,0
福建,2020-02-26,1,5,0,56,36,0
福建,2020-03-01,0,3,0,56,39,0
福建,2020-03-03,0,2,0,56,41,0
福建,2020-03-04,0,5,0,56,46,0
福建,2020-03-05,0,1,0,56,47,0
福建,2020-03-06,0,2,0,56,49,0
福建,2020-03-07,0,7,0,56,56,0
黑龙江,2020-01-26,1,0,0,1,0,0
黑龙江,2020-01-27,1,0,0,2,0,0
黑龙江,2020-01-30,1,0,0,3,0,0
黑龙江,2020-01-31,2,0,0,5,0,0
黑龙江,2020-02-01,1,0,0,6,0,0
黑龙江,2020-02-02,1,0,0,7,0,0
黑龙江,2020-02-03,1,0,0,8,0,0
黑龙江,2020-02-04,1,0,0,9,0,0
黑龙江,2020-02-06,1,0,0,10,0,0
黑龙江,2020-02-07,1,0,0,11,0,0
黑龙江,2020-02-08,2,0,0,13,0,0
黑龙江,2020-02-09,1,0,0,14,0,0
黑龙江,2020-02-10,1,0,0,15,0,0
黑龙江,2020-02-12,1,0,0,16,0,0
黑龙江,2020-02-13,0,1,0,16,1,0
黑龙江,2020-02-15,0,3,0,16,4,0
黑龙江,2020-02-17,1,0,0,17,4,0
黑龙江,2020-02-18,0,2,0,17,6,0
黑龙江,2020-02-22,0,3,0,17,9,0
黑龙江,2020-02-23,0,1,0,17,10,0
黑龙江,2020-02-25,0,1,0,17,11,0
黑龙江,2020-02-26,0,1,0,17,12,0
黑龙江,2020-02-27,0,1,0,17,13,0
黑龙江,2020-03-04,0,1,0,17,14,0
黑龙江,2020-03-05,0,1,0,17,15,0
黑龙江,2020-03-06,0,1,0,17,16,0
黑龙江,2020-03-14,0,1,0,17,17,0
重庆,2020-01-26,1,0,0,1,0,0
重庆,2020-01-27,1,0,0,2,0,0
重庆,2020-01-28,2,0,0,4,0,0
重庆,2020-02-02,1,0,0,5,0,0
重庆,2020-02-03,5,0,0,10,0,0
重庆,2020-02-04,2,0,0,12,0,0
重庆,2020-02-05,1,0,0,13,0,0
重庆,2020-02-06,1,0,0,14,0,0
重庆,2020-02-07,1,0,0,15,0,0
重庆,2020-02-11,1,0,0,16,0,0
重庆,2020-02-12,5,1,0,21,1,0
重庆,2020-02-14,1,2,0,22,3,0
重庆,2020-02-15,1,2,0,23,5,0
重庆,2020-02-16,0,1,0,23,6,0
重庆,2020-02-17,0,1,0,23,7,0
重庆,2020-02-18,0,3,0,23,10,0
重庆,2020-02-19,0,1,0,23,11,0
重庆,2020-02-21,0,1,0,23,12,0
重庆,2020-02-24,0,1,0,23,13,0
重庆,2020-02-28,0,1,0,23,14,0
重庆,2020-03-01,0,1,0,23,15,0
重庆,2020-03-03,0,1,0,23,16,0
重庆,2020-03-04,0,3,0,23,19,0
重庆,2020-03-09,0,1,0,23,20,0
重庆,2020-03-10,0,1,0,23,21,0
重庆,2020-03-12,0,1,0,23,22,0
重庆,2020-03-14,0,1,0,23,23,0
湖北,2020-01-26,5,0,1,5,0,1
湖北,2020-01-27,2,0,0,7,0,1
湖北,2020-01-28,1,0,0,8,0,1
湖北,2020-01-29,2,0,0,10,0,1
湖北,2020-01-30,2,0,0,12,0,1
湖北,2020-01-31,15,0,0,27,0,1
湖北,2020-02-01,8,0,0,35,0,1
湖北,2020-02-03,9,0,0,44,0,1
湖北,2020-02-04,10,0,0,54,0,1
湖北,2020-02-05,10,0,0,64,0,1
湖北,2020-02-06,10,0,0,74,0,1
湖北,2020-02-07,6,1,1,80,1,2
湖北,2020-02-08,2,1,0,82,2,2
湖北,2020-02-09,3,1,0,85,3,2
湖北,2020-02-10,5,0,1,90,3,3
湖北,2020-02-11,0,5,2,90,8,5
湖北,2020-02-12,4,0,0,94,8,5
湖北,2020-02-13,10,3,0,104,11,5
湖北,2020-02-14,12,1,0,116,12,5
湖北,2020-02-15,50,0,1,166,12,6
湖北,2020-02-16,16,6,0,182,18,6
湖北,2020-02-17,3,9,0,185,27,6
湖北,2020-02-18,0,13,0,185,40,6
湖北,2020-02-19,0,9,1,185,49,7
湖北,2020-02-20,3,8,0,188,57,7
湖北,2020-02-21,1,10,1,189,67,8
湖北,2020-02-22,2,11,0,191,78,8
湖北,2020-02-23,3,4,0,194,82,8
湖北,2020-02-24,1,9,0,195,91,8
湖北,2020-02-25,1,3,1,196,94,9
湖北,2020-02-26,1,3,0,197,97,9
湖北,2020-02-27,1,2,0,198,99,9
湖北,2020-02-28,0,8,0,198,107,9
湖北,2020-02-29,0,12,0,198,119,9
湖北,2020-03-01,0,3,0,198,122,9
湖北,2020-03-02,0,6,0,198,128,9
湖北,2020-03-03,0,14,0,198,142,9
湖北,2020-03-04,0,9,0,198,151,9
湖北,2020-03-05,0,8,0,198,159,9
湖北,2020-03-06,0,1,0,198,160,9
湖北,2020-03-07,0,8,0,198,168,9
湖北,2020-03-08,0,4,0,198,172,9
湖北,2020-03-09,0,4,0,198,176,9
湖北,2020-03-10,0,3,0,198,179,9
湖北,2020-03-11,0,1,0,198,180,9
湖北,2020-03-12,0,2,0,198,182,9
湖北,2020-03-15,0,1,0,198,183,9
湖北,2020-03-16,0,1,0,198,184,9
湖北,2020-03-18,0,3,0,198,187,9
湖北,2020-03-25,0,1,0,198,188,9
湖北,2020-03-29,0,1,0,198,189,9
广东,2020-01-26,1,0,0,1,0,0
广东,2020-01-30,2,0,0,3,0,0
广东,2020-01-31,1,0,0,4,0,0
广东,2020-02-02,1,0,0,5,0,0
广东,2020-02-06,0,1,0,5,1,0
广东,2020-02-17,0,1,0,5,2,0
河南,2020-01-26,6,0,0,6,0,0
河南,2020-01-27,1,0,0,7,0,0
河南,2020-01-28,7,0,0,14,0,0
河南,2020-01-29,4,0,0,18,0,0
河南,2020-01-30,13,0,0,31,0,0
河南,2020-01-31,5,2,0,36,2,0
河南,2020-02-01,8,1,0,44,3,0
河南,2020-02-02,6,0,0,50,3,0
河南,2020-02-03,10,0,0,60,3,0
河南,2020-02-04,1,1,0,61,4,0
河南,2020-02-05,4,0,0,65,4,0
河南,2020-02-06,7,2,0,72,6,0
河南,2020-02-07,4,0,0,76,6,0
河南,2020-02-08,6,3,0,82,9,0
河南,2020-02-09,1,0,0,83,9,0
河南,2020-02-10,3,0,0,86,9,0
河南,2020-02-12,1,2,0,87,11,0
河南,2020-02-13,1,0,0,88,11,0
河南,2020-02-14,2,0,0,90,11,0
河南,2020-02-15,1,0,0,91,11,0
河南,2020-02-27,0,2,0,91,13,0
河南,2020-02-28,0,2,0,91,15,0
河南,2020-03-01,0,3,0,91,18,0
河南,2020-03-02,0,1,0,91,19,0
河南,2020-03-04,0,3,1,91,22,1
河南,2020-03-06,0,3,0,91,25,1
河南,2020-03-07,0,1,0,91,26,1
河南,2020-03-08,0,3,0,91,29,1
河南,2020-03-09,0,2,0,91,31,1
河南,2020-03-10,0,3,0,91,34,1
河南,2020-03-11,0,4,0,91,38,1
河南,2020-03-12,0,3,0,91,41,1
河南,2020-03-13,0,0,1,91,41,2
河南,2020-03-14,0,3,0,91,44,2
河南,2020-03-15,0,5,0,91,49,2
河南,2020-03-16,0,3,1,91,52,3
河南,2020-03-20,0,4,1,91,56,4
河南,2020-03-21,0,6,1,91,62,5
河南,2020-03-26,0,7,1,91,69,6
河南,2020-04-01,0,5,1,91,74,7
河南,2020-04-03,0,4,1,91,78,8
河南,2020-04-10,0,4,1,91,82,9
黑龙江,2020-01-26,1,0,0,1,0,0
黑龙江,2020-01-31,1,0,0,2,0,0
黑龙江,2020-02-01,2,0,0,4,0,0
黑龙江,2020-02-02,3,0,0,7,0,0
黑龙江,2020-02-03,5,0,0,12,0,0
黑龙江,2020-02-04,4,0,0,16,0,0
黑龙江,2020-02-05,4,1,0,20,1,0
黑龙江,2020-02-06,16,0,0,36,1,0
黑龙江,2020-02-07,0,0,2,36,1,2
黑龙江,2020-02-08,2,0,0,38,1,2
黑龙江,2020-02-11,1,0,0,39,1,2
黑龙江,2020-02-13,9,0,0,48,1,2
黑龙江,2020-02-15,1,0,0,49,1,2
黑龙江,2020-02-16,1,0,0,50,1,2
黑龙江,2020-02-17,2,3,0,52,4,2
黑龙江,2020-02-18,0,0,1,52,4,3
黑龙江,2020-02-19,0,4,0,52,8,3
黑龙江,2020-02-20,0,3,0,52,11,3
黑龙江,2020-02-21,0,5,0,52,16,3
黑龙江,2020-02-22,0,3,0,52,19,3
黑龙江,2020-02-23,0,1,0,52,20,3
黑龙江,2020-02-25,0,4,0,52,24,3
黑龙江,2020-02-26,0,5,0,52,29,3
黑龙江,2020-02-28,0,3,0,52,32,3
黑龙江,2020-02-29,0,4,0,52,36,3
黑龙江,2020-03-01,0,1,0,52,37,3
黑龙江,2020-03-02,0,2,0,52,39,3
黑龙江,2020-03-04,0,1,0,52,40,3
黑龙江,2020-03-07,0,1,0,52,41,3
黑龙江,2020-03-08,0,4,0,52,45,3
黑龙江,2020-03-09,0,1,0,52,46,3
黑龙江,2020-03-11,0,1,0,52,47,3
黑龙江,2020-03-14,0,1,0,52,48,3
黑龙江,2020-03-19,0,1,0,52,49,3
山西,2020-01-26,2,0,0,2,0,0
山西,2020-01-29,1,0,0,3,0,0
山西,2020-02-04,1,0,0,4,0,0
山西,2020-02-06,0,1,0,4,1,0
山西,2020-02-08,2,0,0,6,1,0
山西,2020-02-09,1,0,0,7,1,0
山西,2020-02-10,0,1,0,7,2,0
山西,2020-02-17,1,0,0,8,2,0
山西,2020-02-18,0,1,0,8,3,0
山西,2020-02-23,0,2,0,8,5,0
山西,2020-02-24,0,1,0,8,6,0
山西,2020-02-28,0,1,0,8,7,0
山西,2020-02-29,0,1,0,8,8,0
吉林,2020-01-26,1,0,0,1,0,0
吉林,2020-01-27,1,0,0,2,0,0
吉林,2020-02-02,3,0,0,5,0,0
吉林,2020-02-03,5,0,0,10,0,0
吉林,2020-02-04,2,0,0,12,0,0
吉林,2020-02-05,1,0,0,13,0,0
吉林,2020-02-06,1,1,1,14,1,1
吉林,2020-02-07,2,0,0,16,1,1
吉林,2020-02-08,2,0,0,18,1,1
吉林,2020-02-10,0,1,0,18,2,1
吉林,2020-02-12,1,2,0,19,4,1
吉林,2020-02-13,1,0,0,20,4,1
吉林,2020-02-15,0,2,0,20,6,1
吉林,2020-02-18,1,0,0,21,6,1
吉林,2020-02-19,0,3,0,21,9,1
吉林,2020-02-20,0,1,0,21,10,1
吉林,2020-02-21,0,1,0,21,11,1
吉林,2020-02-22,0,1,0,21,12,1
吉林,2020-02-25,0,1,0,21,13,1
吉林,2020-02-26,0,2,0,21,15,1
吉林,2020-02-27,0,1,0,21,16,1
吉林,2020-03-02,0,4,0,21,20,1
内蒙古,2020-01-26,1,0,0,1,0,0
内蒙古,2020-02-06,1,0,0,2,0,0
内蒙古,2020-02-07,1,0,0,3,0,0
内蒙古,2020-02-09,3,0,0,6,0,0
内蒙古,2020-02-17,1,0,0,7,0,0
内蒙古,2020-02-21,0,1,0,7,1,0
内蒙古,2020-02-26,0,1,0,7,2,0
内蒙古,2020-02-29,0,1,0,7,3,0
内蒙古,2020-03-02,0,1,0,7,4,0
内蒙古,2020-03-04,0,1,0,7,5,0
内蒙古,2020-03-07,0,2,0,7,7,0
重庆,2020-01-26,2,0,0,2,0,0
重庆,2020-02-02,1,0,0,3,0,0
重庆,2020-02-03,1,0,0,4,0,0
重庆,2020-02-04,3,0,0,7,0,0
重庆,2020-02-05,3,0,0,10,0,0
重庆,2020-02-06,3,0,0,13,0,0
重庆,2020-02-10,1,0,0,14,0,0
重庆,2020-02-11,1,0,0,15,0,0
重庆,2020-02-13,1,0,0,16,0,0
重庆,2020-02-14,1,2,0,17,2,0
重庆,2020-02-15,1,0,0,18,2,0
重庆,2020-02-18,0,1,0,18,3,0
重庆,2020-02-19,0,1,0,18,4,0
重庆,2020-02-20,0,1,0,18,5,0
重庆,2020-02-22,0,1,0,18,6,0
重庆,2020-02-23,0,1,0,18,7,0
重庆,2020-02-28,0,1,0,18,8,0
重庆,2020-02-29,0,2,0,18,10,0
重庆,2020-03-02,0,1,0,18,11,0
重庆,2020-03-05,0,1,0,18,12,0
重庆,2020-03-06,0,2,0,18,14,0
重庆,2020-03-09,0,1,0,18,15,0
重庆,2020-03-11,0,2,0,18,17,0
重庆,2020-03-12,0,1,0,18,18,0
陕西,2020-01-26,1,0,0,1,0,0
陕西,2020-01-27,2,0,0,3,0,0
陕西,2020-01-29,2,0,0,5,0,0
陕西,2020-01-30,1,0,0,6,0,0
陕西,2020-02-02,1,0,0,7,0,0
陕西,2020-02-04,3,0,0,10,0,0
陕西,2020-02-08,4,0,0,14,0,0
陕西,2020-02-09,1,0,0,15,0,0
陕西,2020-02-14,1,0,0,16,0,0
陕西,2020-02-15,0,2,0,16,2,0
陕西,2020-02-16,0,1,0,16,3,0
陕西,2020-02-17,0,1,0,16,4,0
陕西,2020-02-19,0,1,0,16,5,0
陕西,2020-02-20,0,1,0,16,6,0
陕西,2020-02-23,0,1,0,16,7,0
陕西,2020-02-25,0,1,0,16,8,0
陕西,2020-02-26,0,1,0,16,9,0
陕西,2020-02-29,0,1,0,16,10,0
陕西,2020-03-02,0,1,0,16,11,0
陕西,2020-03-04,0,3,0,16,14,0
陕西,2020-03-11,0,1,0,16,15,0
陕西,2020-03-25,0,1,0,16,16,0
河北,2020-01-26,1,0,0,1,0,0
河北,2020-01-27,1,0,0,2,0,0
河北,2020-01-28,1,0,0,3,0,0
河北,2020-01-29,2,0,0,5,0,0
河北,2020-01-30,2,0,0,7,0,0
河北,2020-01-31,3,0,0,10,0,0
河北,2020-02-02,4,0,0,14,0,0
河北,2020-02-03,2,0,0,16,0,0
河北,2020-02-05,3,0,0,19,0,0
河北,2020-02-07,2,1,0,21,1,0
河北,2020-02-08,0,3,1,21,4,1
河北,2020-02-11,0,1,0,21,5,1
河北,2020-02-13,1,3,0,22,8,1
河北,2020-02-15,0,2,0,22,10,1
河北,2020-02-16,1,0,0,23,10,1
河北,2020-02-20,0,3,0,23,13,1
河北,2020-02-21,0,2,0,23,15,1
河北,2020-02-22,0,3,0,23,18,1
河北,2020-02-23,0,1,0,23,19,1
河北,2020-02-25,0,1,0,23,20,1
河北,2020-02-26,0,2,0,23,22,1
内蒙古,2020-01-26,1,0,0,1,0,0
内蒙古,2020-02-27,0,1,0,1,1,0
江苏,2020-01-26,3,0,0,3,0,0
江苏,2020-01-27,5,0,0,8,0,0
江苏,2020-01-29,7,0,0,15,0,0
江苏,2020-01-30,5,0,0,20,0,0
江苏,2020-01-31,3,0,0,23,0,0
江苏,2020-02-01,7,0,0,30,0,0
江苏,2020-02-02,6,0,0,36,0,0
江苏,2020-02-03,3,0,0,39,0,0
江苏,2020-02-04,6,0,0,45,0,0
江苏,2020-02-05,0,3,0,45,3,0
江苏,2020-02-06,4,0,0,49,3,0
江苏,2020-02-07,3,0,0,52,3,0
江苏,2020-02-08,4,0,0,56,3,0
江苏,2020-02-09,4,5,0,60,8,0
江苏,2020-02-10,3,2,0,63,10,0
江苏,2020-02-11,3,0,0,66,10,0
江苏,2020-02-12,5,6,0,71,16,0
江苏,2020-02-13,5,1,0,76,17,0
江苏,2020-02-14,1,3,0,77,20,0
江苏,2020-02-15,1,3,0,78,23,0
江苏,2020-02-16,1,5,0,79,28,0
江苏,2020-02-17,0,14,0,79,42,0
江苏,2020-02-18,0,4,0,79,46,0
江苏,2020-02-19,0,5,0,79,51,0
江苏,2020-02-20,0,4,0,79,55,0
江苏,2020-02-21,0,3,0,79,58,0
江苏,2020-02-22,0,5,0,79,63,0
江苏,2020-02-23,0,3,0,79,66,0
江苏,2020-02-24,0,1,0,79,67,0
江苏,2020-02-26,0,2,0,79,69,0
江苏,2020-02-27,0,2,0,79,71,0
江苏,2020-03-04,0,2,0,79,73,0
江苏,2020-03-06,0,2,0,79,75,0
江苏,2020-03-07,0,1,0,79,76,0
江苏,2020-03-10,0,2,0,79,78,0
江苏,2020-03-12,0,1,0,79,79,0
河南,2020-01-26,1,0,0,1,0,0
河南,2020-01-27,1,0,0,2,0,0
河南,2020-01-29,1,0,0,3,0,0
河南,2020-01-30,5,0,0,8,0,0
河南,2020-01-31,4,0,0,12,0,0
河南,2020-02-01,1,0,0,13,0,0
河南,2020-02-02,2,0,0,15,0,0
河南,2020-02-03,4,0,0,19,0,0
河南,2020-02-04,5,0,0,24,0,0
河南,2020-02-05,2,0,0,26,0,0
河南,2020-02-06,2,0,0,28,0,0
河南,2020-02-07,2,0,0,30,0,0
河南,2020-02-08,1,2,0,31,2,0
河南,2020-02-10,1,0,0,32,2,0
河南,2020-02-11,2,0,0,34,2,0
河南,2020-02-12,0,1,0,34,3,0
河南,2020-02-13,3,0,0,37,3,0
河南,2020-02-14,0,3,0,37,6,0
河南,2020-02-15,1,2,0,38,8,0
河南,2020-02-16,0,1,0,38,9,0
河南,2020-02-17,0,2,0,38,11,0
河南,2020-02-18,1,0,0,39,11,0
河南,2020-02-19,0,5,0,39,16,0
河南,2020-02-21,0,4,0,39,20,0
河南,2020-02-22,0,4,0,39,24,0
河南,2020-02-23,0,2,0,39,26,0
河南,2020-02-24,0,6,0,39,32,0
河南,2020-02-26,0,1,0,39,33,0
河南,2020-02-27,0,1,0,39,34,0
河南,2020-02-28,0,1,0,39,35,0
河南,2020-02-29,0,1,0,39,36,0
四川,2020-01-26,1,0,0,1,0,0
四川,2020-01-28,1,0,0,2,0,0
四川,2020-01-29,3,0,0,5,0,0
四川,2020-01-30,2,0,0,7,0,0
四川,2020-02-05,1,0,0,8,0,0
四川,2020-02-06,1,0,0,9,0,0
四川,2020-02-09,0,3,0,9,3,0
四川,2020-02-11,1,0,0,10,3,0
四川,2020-02-12,1,0,0,11,3,0
四川,2020-02-14,0,3,0,11,6,0
四川,2020-02-17,1,0,0,12,6,0
四川,2020-02-19,0,1,0,12,7,0
四川,2020-02-22,0,1,0,12,8,0
四川,2020-02-25,0,2,0,12,10,0
四川,2020-03-05,0,1,0,12,11,0
四川,2020-03-10,0,1,0,12,12,0
甘肃,2020-01-26,1,0,0,1,0,0
甘肃,2020-01-28,1,0,0,2,0,0
甘肃,2020-02-09,0,1,0,2,1,0
甘肃,2020-02-13,0,1,0,2,2,0
云南,2020-01-26,1,0,0,1,0,0
云南,2020-01-27,1,0,0,2,0,0
云南,2020-01-29,2,0,0,4,0,0
云南,2020-01-31,2,0,0,6,0,0
云南,2020-02-02,2,0,0,8,0,0
云南,2020-02-03,1,0,0,9,0,0
云南,2020-02-04,1,0,0,10,0,0
云南,2020-02-06,0,1,0,10,1,0
云南,2020-02-08,2,1,0,12,2,0
云南,2020-02-11,2,0,0,14,2,0
云南,2020-02-13,5,0,0,19,2,0
云南,2020-02-14,6,0,0,25,2,0
云南,2020-02-20,0,3,0,25,5,0
云南,2020-02-21,0,1,0,25,6,0
云南,2020-02-22,0,4,0,25,10,0
云南,2020-02-23,0,4,0,25,14,0
云南,2020-02-25,0,1,0,25,15,0
云南,2020-02-28,0,5,0,25,20,0
云南,2020-03-01,0,5,0,25,25,0
江苏,2020-01-26,2,0,0,2,0,0
江苏,2020-02-01,1,0,0,3,0,0
江苏,2020-02-03,2,0,0,5,0,0
江苏,2020-02-04,1,0,0,6,0,0
江苏,2020-02-05,2,0,0,8,0,0
江苏,2020-02-06,1,0,0,9,0,0
江苏,2020-02-07,2,1,0,11,1,0
江苏,2020-02-08,1,0,0,12,1,0
江苏,2020-02-11,0,1,0,12,2,0
江苏,2020-02-15,0,2,0,12,4,0
江苏,2020-02-17,0,1,0,12,5,0
江苏,2020-02-18,0,1,0,12,6,0
江苏,2020-02-19,0,2,0,12,8,0
江苏,2020-02-21,0,1,0,12,9,0
江苏,2020-02-22,0,1,0,12,10,0
江苏,2020-02-29,0,1,0,12,11,0
江苏,2020-03-08,0,1,0,12,12,0
四川,2020-01-26,2,0,0,2,0,0
四川,2020-02-08,1,0,0,3,0,0
四川,2020-02-09,0,1,0,3,1,0
四川,2020-02-13,0,1,0,3,2,0
四川,2020-02-24,1,0,0,4,2,0
四川,2020-03-09,0,1,0,4,3,0
四川,2020-03-12,0,1,0,4,4,0
陕西,2020-01-27,3,0,0,3,0,0
陕西,2020-01-28,1,0,0,4,0,0
陕西,2020-01-31,2,0,0,6,0,0
陕西,2020-02-01,1,0,0,7,0,0
陕西,2020-02-02,1,0,0,8,0,0
陕西,2020-02-03,2,0,0,10,0,0
陕西,2020-02-06,2,2,0,12,2,0
陕西,2020-02-08,1,0,0,13,2,0
陕西,2020-02-12,0,3,0,13,5,0
陕西,2020-02-13,0,2,0,13,7,0
陕西,2020-02-16,0,1,0,13,8,0
陕西,2020-02-17,0,1,0,13,9,0
陕西,2020-02-20,0,1,0,13,10,0
陕西,2020-02-21,0,1,0,13,11,0
陕西,2020-02-24,0,1,0,13,12,0
陕西,2020-03-04,0,1,0,13,13,0
上海,2020-01-27,1,0,0,1,0,0
上海,2020-01-28,1,0,0,2,0,0
上海,2020-01-31,3,0,0,5,0,0
上海,2020-02-01,3,0,0,8,0,0
上海,2020-02-02,2,0,0,10,0,0
上海,2020-02-03,1,0,0,11,0,0
上海,2020-02-04,1,0,0,12,0,0
上海,2020-02-05,3,0,0,15,0,0
上海,2020-02-06,1,0,0,16,0,0
上海,2020-02-07,1,0,0,17,0,0
上海,2020-02-09,1,0,0,18,0,0
上海,2020-02-10,2,0,0,20,0,0
上海,2020-02-13,0,1,0,20,1,0
上海,2020-02-14,0,1,0,20,2,0
上海,2020-02-15,1,3,0,21,5,0
上海,2020-02-16,0,1,0,21,6,0
上海,2020-02-17,0,1,0,21,7,0
上海,2020-02-20,0,2,0,21,9,0
上海,2020-02-21,0,1,0,21,10,0
上海,2020-02-23,0,2,0,21,12,0
上海,2020-02-26,0,1,0,21,13,0
上海,2020-02-29,0,1,0,21,14,0
上海,2020-03-01,0,1,0,21,15,0
上海,2020-03-05,0,1,0,21,16,0
上海,2020-03-07,0,2,0,21,18,0
上海,2020-03-10,0,1,0,21,19,0
上海,2020-03-23,1,0,0,22,19,0
北京,2020-01-27,0,9,1,0,9,1
北京,2020-01-28,0,2,0,0,11,1
北京,2020-01-30,0,1,0,0,12,1
北京,2020-02-01,0,4,0,0,16,1
北京,2020-02-02,0,3,0,0,19,1
北京,2020-02-03,0,11,0,0,30,1
北京,2020-02-04,0,1,0,0,31,1
北京,2020-02-06,0,2,0,0,33,1
北京,2020-02-07,0,1,1,0,34,2
北京,2020-02-08,0,3,0,0,37,2
北京,2020-02-09,0,7,0,0,44,2
北京,2020-02-10,0,4,1,0,48,3
北京,2020-02-11,0,8,0,0,56,3
北京,2020-02-12,0,12,0,0,68,3
北京,2020-02-13,0,11,0,0,79,3
北京,2020-02-14,0,18,1,0,97,4
北京,2020-02-15,0,8,0,0,105,4
北京,2020-02-16,0,9,0,0,114,4
北京,2020-02-17,0,8,0,0,122,4
北京,2020-02-18,0,23,0,0,145,4
北京,2020-02-19,0,8,0,0,153,4
北京,2020-02-20,0,16,0,0,169,4
北京,2020-02-21,0,9,0,0,178,4
北京,2020-02-22,0,11,0,0,189,4
北京,2020-02-23,0,9,0,0,198,4
北京,2020-02-24,0,17,0,0,215,4
北京,2020-02-25,0,20,0,0,235,4
北京,2020-02-26,0,13,1,0,248,5
北京,2020-02-27,0,9,2,0,257,7
北京,2020-02-28,0,14,1,0,271,8
北京,2020-02-29,0,5,0,0,276,8
北京,2020-03-01,0,6,0,0,282,8
北京,2020-03-02,0,6,0,0,288,8
北京,2020-03-03,0,6,0,0,294,8
北京,2020-03-04,0,3,0,0,297,8
北京,2020-03-05,0,1,0,0,298,8
北京,2020-03-06,0,5,0,0,303,8
北京,2020-03-07,0,5,0,0,308,8
北京,2020-03-08,0,7,0,0,315,8
北京,2020-03-09,0,5,0,0,320,8
北京,2020-03-10,0,6,0,0,326,8
北京,2020-03-11,0,8,0,0,334,8
北京,2020-03-12,0,8,0,0,342,8
北京,2020-03-13,0,7,0,0,349,8
北京,2020-03-14,0,4,0,0,353,8
北京,2020-03-15,0,5,0,0,358,8
北京,2020-03-16,0,10,0,0,368,8
北京,2020-03-17,0,5,0,0,373,8
北京,2020-03-18,0,6,0,0,379,8
北京,2020-03-19,0,5,0,0,384,8
北京,2020-03-20,0,8,0,0,392,8
北京,2020-03-21,0,6,0,0,398,8
北京,2020-03-22,0,2,0,0,400,8
北京,2020-03-23,0,1,0,0,401,8
北京,2020-03-25,0,2,0,0,403,8
北京,2020-03-26,0,3,0,0,406,8
北京,2020-03-27,0,3,0,0,409,8
北京,2020-03-28,0,2,0,0,411,8
北京,2020-03-29,0,1,0,0,412,8
北京,2020-03-30,0,4,0,0,416,8
北京,2020-03-31,0,2,0,0,418,8
北京,2020-04-01,0,6,0,0,424,8
北京,2020-04-02,0,10,0,0,434,8
北京,2020-04-03,0,4,0,0,438,8
北京,2020-04-04,0,3,0,0,441,8
北京,2020-04-05,0,2,0,0,443,8
北京,2020-04-06,0,5,0,0,448,8
北京,2020-04-07,0,7,0,0,455,8
北京,2020-04-08,0,9,0,0,464,8
北京,2020-04-09,0,5,0,0,469,8
北京,2020-04-10,0,5,0,0,474,8
北京,2020-04-11,0,5,0,0,479,8
北京,2020-04-12,0,5,0,0,484,8
北京,2020-04-13,0,7,0,0,491,8
北京,2020-04-14,0,4,0,0,495,8
北京,2020-04-15,0,8,0,0,503,8
北京,2020-04-16,0,6,0,0,509,8
北京,2020-04-18,0,1,0,0,510,8
北京,2020-04-19,0,4,0,0,514,8
北京,2020-04-20,0,2,0,0,516,8
北京,2020-04-21,0,2,0,0,518,8
北京,2020-04-22,0,4,0,0,522,8
北京,2020-04-23,0,2,0,0,524,8
北京,2020-04-24,0,1,0,0,525,8
北京,2020-04-26,0,0,1,0,525,9
北京,2020-04-27,0,2,0,0,527,9
北京,2020-04-28,0,2,0,0,529,9
北京,2020-04-29,0,4,0,0,533,9
北京,2020-04-30,0,5,0,0,538,9
北京,2020-05-02,0,4,0,0,542,9
北京,2020-05-03,0,2,0,0,544,9
北京,2020-05-04,0,1,0,0,545,9
北京,2020-05-05,0,1,0,0,546,9
北京,2020-05-06,0,2,0,0,548,9
北京,2020-05-07,0,3,0,0,551,9
北京,2020-05-08,0,3,0,0,554,9
北京,2020-05-09,0,2,0,0,556,9
北京,2020-05-10,0,3,0,0,559,9
北京,2020-05-11,0,3,0,0,562,9
北京,2020-05-12,0,2,0,0,564,9
北京,2020-05-13,0,1,0,0,565,9
北京,2020-05-15,0,2,0,0,567,9
北京,2020-05-16,0,1,0,0,568,9
北京,2020-05-17,0,1,0,0,569,9
北京,2020-05-20,0,1,0,0,570,9
北京,2020-05-23,0,2,0,0,572,9
北京,2020-06-02,1,1,0,1,573,9
北京,2020-06-03,0,1,0,1,574,9
北京,2020-06-08,0,1,0,1,575,9
北京,2020-06-29,0,1,0,1,576,9
新疆,2020-01-27,1,0,0,1,0,0
新疆,2020-02-10,1,0,0,2,0,0
新疆,2020-02-12,0,0,1,2,0,1
新疆,2020-02-14,1,0,0,3,0,1
新疆,2020-02-15,0,1,0,3,1,1
新疆,2020-02-17,1,0,0,4,1,1
新疆,2020-02-28,0,1,0,4,2,1
新疆,2020-03-02,0,1,0,4,3,1
新疆,2020-01-27,1,0,0,1,0,0
新疆,2020-02-13,0,1,0,1,1,0
天津,2020-01-27,3,0,0,3,0,0
天津,2020-02-04,1,0,0,4,0,0
天津,2020-02-10,0,1,0,4,1,0
天津,2020-02-13,0,1,0,4,2,0
天津,2020-02-22,0,1,0,4,3,0
天津,2020-02-23,0,1,0,4,4,0
河北,2020-01-27,2,0,0,2,0,0
河北,2020-01-28,1,0,0,3,0,0
河北,2020-01-29,1,0,0,4,0,0
河北,2020-02-03,1,0,0,5,0,0
河北,2020-02-05,2,0,0,7,0,0
河北,2020-02-08,1,0,0,8,0,0
河北,2020-02-10,0,2,0,8,2,0
河北,2020-02-13,0,2,0,8,4,0
河北,2020-02-17,0,2,0,8,6,0
河北,2020-02-22,0,1,0,8,7,0
河北,2020-02-23,0,1,0,8,8,0
天津,2020-01-27,1,0,0,1,0,0
天津,2020-01-30,1,0,0,2,0,0
天津,2020-02-02,0,1,0,2,1,0
天津,2020-02-14,0,1,0,2,2,0
上海,2020-01-27,2,0,0,2,0,0
上海,2020-01-30,2,0,0,4,0,0
上海,2020-01-31,1,0,0,5,0,0
上海,2020-02-05,2,0,0,7,0,0
上海,2020-02-08,0,1,0,7,1,0
上海,2020-02-10,0,1,0,7,2,0
上海,2020-02-15,0,1,0,7,3,0
上海,2020-02-16,0,1,0,7,4,0
上海,2020-02-21,0,1,0,7,5,0
上海,2020-02-25,0,1,0,7,6,0
上海,2020-03-07,0,1,0,7,7,0
上海,2020-01-27,2,0,0,2,0,0
上海,2020-01-28,1,0,0,3,0,0
上海,2020-01-29,1,0,0,4,0,0
上海,2020-01-31,1,0,0,5,0,0
上海,2020-02-05,0,1,0,5,1,0
上海,2020-02-11,1,0,0,6,1,0
上海,2020-02-15,0,1,0,6,2,0
上海,2020-02-20,0,1,0,6,3,0
上海,2020-02-23,0,1,0,6,4,0
上海,2020-03-04,0,1,0,6,5,0
上海,2020-01-27,1,0,0,1,0,0
上海,2020-01-29,1,0,0,2,0,0
上海,2020-02-03,1,0,0,3,0,0
上海,2020-02-05,1,0,0,4,0,0
上海,2020-02-06,1,0,0,5,0,0
上海,2020-02-07,1,0,0,6,0,0
上海,2020-02-08,0,1,0,6,1,0
上海,2020-02-09,1,0,0,7,1,0
上海,2020-02-10,1,0,0,8,1,0
上海,2020-02-13,1,0,0,9,1,0
上海,2020-02-15,0,1,0,9,2,0
上海,2020-02-20,0,1,0,9,3,0
上海,2020-02-23,0,3,0,9,6,0
上海,2020-02-28,0,1,0,9,7,0
河南,2020-01-27,2,0,0,2,0,0
河南,2020-02-01,5,0,0,7,0,0
河南,2020-02-02,1,0,0,8,0,0
河南,2020-02-03,4,1,0,12,1,0
河南,2020-02-04,3,0,0,15,1,0
河南,2020-02-05,2,0,0,17,1,0
河南,2020-02-06,1,0,0,18,1,0
河南,2020-02-07,2,0,0,20,1,0
河南,2020-02-08,4,0,0,24,1,0
河南,2020-02-09,1,0,0,25,1,0
河南,2020-02-10,3,0,0,28,1,0
河南,2020-02-11,0,2,0,28,3,0
河南,2020-02-12,1,0,0,29,3,0
河南,2020-02-14,1,0,0,30,3,0
河南,2020-02-16,2,0,0,32,3,0
甘肃,2020-01-27,1,0,0,1,0,0
甘肃,2020-02-09,0,1,0,1,1,0
上海,2020-01-27,5,0,0,5,0,0
上海,2020-01-28,2,0,0,7,0,0
上海,2020-01-29,1,0,0,8,0,0
上海,2020-02-01,1,0,0,9,0,0
上海,2020-02-04,3,0,0,12,0,0
上海,2020-02-05,2,2,0,14,2,0
上海,2020-02-07,1,1,0,15,3,0
上海,2020-02-08,1,0,0,16,3,0
上海,2020-02-14,0,2,0,16,5,0
上海,2020-02-15,0,2,0,16,7,0
上海,2020-02-17,0,2,0,16,9,0
上海,2020-02-19,0,1,0,16,10,0
上海,2020-02-22,0,1,0,16,11,0
上海,2020-02-23,0,1,0,16,12,0
上海,2020-02-26,0,1,0,16,13,0
上海,2020-03-01,0,1,0,16,14,0
上海,2020-03-12,0,1,0,16,15,0
辽宁,2020-01-27,1,0,0,1,0,0
辽宁,2020-02-02,1,0,0,2,0,0
辽宁,2020-02-08,1,0,0,3,0,0
辽宁,2020-02-12,0,1,0,3,1,0
辽宁,2020-02-15,0,1,0,3,2,0
辽宁,2020-02-18,0,1,0,3,3,0
上海,2020-01-27,2,0,0,2,0,0
上海,2020-01-29,1,0,0,3,0,0
上海,2020-01-30,2,0,0,5,0,0
上海,2020-01-31,2,0,0,7,0,0
上海,2020-02-02,2,0,0,9,0,0
上海,2020-02-03,1,0,0,10,0,0
上海,2020-02-04,1,0,0,11,0,0
上海,2020-02-05,1,1,0,12,1,0
上海,2020-02-08,2,1,0,14,2,0
上海,2020-02-09,1,0,0,15,2,0
上海,2020-02-10,2,0,0,17,2,0
上海,2020-02-12,1,1,0,18,3,0
上海,2020-02-13,0,1,0,18,4,0
上海,2020-02-14,0,1,0,18,5,0
上海,2020-02-15,0,2,0,18,7,0
上海,2020-02-16,0,1,0,18,8,0
上海,2020-02-17,0,3,0,18,11,0
上海,2020-02-18,0,3,0,18,14,0
上海,2020-02-20,1,1,0,19,15,0
上海,2020-02-23,0,1,0,19,16,0
上海,2020-02-24,0,1,0,19,17,0
上海,2020-02-28,0,1,0,19,18,0
上海,2020-03-04,0,1,0,19,19,0
重庆,2020-01-27,1,0,0,1,0,0
重庆,2020-01-29,1,0,0,2,0,0
重庆,2020-01-30,1,0,0,3,0,0
重庆,2020-02-01,1,0,0,4,0,0
重庆,2020-02-02,2,0,0,6,0,0
重庆,2020-02-03,1,0,0,7,0,0
重庆,2020-02-04,1,0,0,8,0,0
重庆,2020-02-10,1,0,0,9,0,0
重庆,2020-02-12,2,1,0,11,1,0
重庆,2020-02-13,4,0,0,15,1,0
重庆,2020-02-14,0,1,0,15,2,0
重庆,2020-02-16,0,1,0,15,3,0
重庆,2020-02-19,0,2,0,15,5,0
重庆,2020-02-25,0,3,0,15,8,0
重庆,2020-03-02,0,1,0,15,9,0
重庆,2020-03-03,0,1,0,15,10,0
重庆,2020-03-05,0,1,0,15,11,0
重庆,2020-03-07,0,1,0,15,12,0
重庆,2020-03-08,0,1,0,15,13,0
重庆,2020-03-10,0,1,0,15,14,0
重庆,2020-03-12,0,1,0,15,15,0
上海,2020-01-27,9,0,0,9,0,0
上海,2020-01-28,3,0,0,12,0,0
上海,2020-01-29,1,0,0,13,0,0
上海,2020-01-30,9,0,0,22,0,0
上海,2020-01-31,5,0,0,27,0,0
上海,2020-02-01,5,0,0,32,0,0
上海,2020-02-02,7,0,0,39,0,0
上海,2020-02-03,1,0,0,40,0,0
上海,2020-02-04,5,0,0,45,0,0
上海,2020-02-05,2,3,0,47,3,0
上海,2020-02-06,3,3,0,50,6,0
上海,2020-02-07,3,0,0,53,6,0
上海,2020-02-08,3,2,0,56,8,0
上海,2020-02-09,0,1,0,56,9,0
上海,2020-02-11,0,1,0,56,10,0
上海,2020-02-12,0,2,0,56,12,0
上海,2020-02-14,0,11,0,56,23,0
上海,2020-02-15,1,4,0,57,27,0
上海,2020-02-16,2,4,0,59,31,0
上海,2020-02-17,1,2,0,60,33,0
上海,2020-02-18,0,4,0,60,37,0
上海,2020-02-20,0,1,0,60,38,0
上海,2020-02-21,0,4,0,60,42,0
上海,2020-02-22,0,1,0,60,43,0
上海,2020-02-23,0,5,0,60,48,0
上海,2020-02-24,0,1,0,60,49,0
上海,2020-02-25,0,1,0,60,50,0
上海,2020-02-27,0,1,0,60,51,0
上海,2020-02-28,0,1,0,60,52,0
上海,2020-03-02,1,1,0,61,53,0
上海,2020-03-05,0,1,0,61,54,0
上海,2020-03-06,0,1,0,61,55,0
上海,2020-03-07,0,2,0,61,57,0
上海,2020-03-08,0,1,0,61,58,0
上海,2020-03-13,0,1,0,61,59,0
重庆,2020-01-27,1,0,0,1,0,0
重庆,2020-01-30,1,0,0,2,0,0
重庆,2020-02-10,0,2,0,2,2,0
上海,2020-01-27,2,0,0,2,0,0
上海,2020-02-04,2,0,0,4,0,0
上海,2020-02-05,1,0,0,5,0,0
上海,2020-02-06,0,1,0,5,1,0
上海,2020-02-07,0,1,0,5,2,0
上海,2020-02-14,0,1,0,5,3,0
上海,2020-02-15,0,1,0,5,4,0
上海,2020-02-16,0,1,0,5,5,0
上海,2020-02-25,1,0,0,6,5,0
上海,2020-03-09,0,1,0,6,6,0
海南,2020-01-27,1,0,0,1,0,0
海南,2020-01-29,2,0,0,3,0,0
海南,2020-01-30,1,0,0,4,0,0
海南,2020-02-01,1,0,0,5,0,0
海南,2020-02-02,1,0,0,6,0,0
海南,2020-02-09,0,0,1,6,0,1
海南,2020-02-14,0,1,0,6,1,1
海南,2020-02-16,0,2,0,6,3,1
海南,2020-02-18,0,1,0,6,4,1
海南,2020-02-28,0,1,0,6,5,1
湖北,2020-01-27,1,0,0,1,0,0
湖北,2020-01-28,2,0,0,3,0,0
湖北,2020-01-29,2,0,0,5,0,0
湖北,2020-01-30,2,2,0,7,2,0
湖北,2020-02-03,3,0,0,10,2,0
湖北,2020-02-09,0,4,0,10,6,0
湖北,2020-02-11,0,1,0,10,7,0
湖北,2020-02-12,0,1,0,10,8,0
湖北,2020-02-17,0,2,0,10,10,0
湖北,2020-02-21,1,0,0,11,10,0
湖北,2020-02-29,0,1,0,11,11,0
山东,2020-01-27,1,0,0,1,0,0
山东,2020-01-28,2,0,0,3,0,0
山东,2020-01-31,2,0,0,5,0,0
山东,2020-02-01,4,0,0,9,0,0
山东,2020-02-02,2,1,0,11,1,0
山东,2020-02-03,1,0,0,12,1,0
山东,2020-02-04,2,0,0,14,1,0
山东,2020-02-05,4,0,0,18,1,0
山东,2020-02-06,2,0,0,20,1,0
山东,2020-02-08,3,0,0,23,1,0
山东,2020-02-09,3,0,0,26,1,0
山东,2020-02-10,6,0,0,32,1,0
山东,2020-02-12,0,3,0,32,4,0
山东,2020-02-15,0,1,0,32,5,0
山东,2020-02-17,0,1,0,32,6,0
山东,2020-02-18,0,0,1,32,6,1
山东,2020-02-19,1,3,0,33,9,1
山东,2020-02-20,1,3,0,34,12,1
山东,2020-02-21,1,6,0,35,18,1
山东,2020-02-22,0,3,0,35,21,1
山东,2020-02-24,0,1,1,35,22,2
山东,2020-02-26,0,1,0,35,23,2
山东,2020-02-27,0,1,0,35,24,2
山东,2020-02-28,0,2,0,35,26,2
山东,2020-02-29,0,4,0,35,30,2
山东,2020-03-01,0,3,0,35,33,2
河北,2020-01-27,1,0,0,1,0,0
河北,2020-01-28,2,0,0,3,0,0
河北,2020-01-30,4,0,0,7,0,0
河北,2020-01-31,1,0,0,8,0,0
河北,2020-02-01,3,0,0,11,0,0
河北,2020-02-04,1,0,0,12,0,0
河北,2020-02-05,5,0,0,17,0,0
河北,2020-02-06,2,0,0,19,0,0
河北,2020-02-07,4,2,0,23,2,0
河北,2020-02-08,4,0,0,27,2,0
河北,2020-02-09,1,0,0,28,2,0
河北,2020-02-10,3,0,0,31,2,0
河北,2020-02-11,2,1,0,33,3,0
河北,2020-02-12,2,0,0,35,3,0
河北,2020-02-13,8,1,0,43,4,0
河北,2020-02-14,3,0,0,46,4,0
河北,2020-02-15,5,5,0,51,9,0
河北,2020-02-17,0,1,1,51,10,1
河北,2020-02-18,4,1,0,55,11,1
河北,2020-02-19,1,2,0,56,13,1
河北,2020-02-20,1,3,0,57,16,1
河北,2020-02-21,0,3,0,57,19,1
河北,2020-02-22,1,1,0,58,20,1
河北,2020-02-24,0,7,0,58,27,1
河北,2020-02-25,0,3,0,58,30,1
河北,2020-02-26,0,6,0,58,36,1
河北,2020-02-27,0,4,0,58,40,1
河北,2020-02-28,0,1,0,58,41,1
河北,2020-02-29,0,1,0,58,42,1
河北,2020-03-01,0,6,0,58,48,1
河北,2020-03-02,0,2,0,58,50,1
河北,2020-03-03,0,1,0,58,51,1
河北,2020-03-04,0,1,0,58,52,1
河北,2020-03-05,0,2,0,58,54,1
河北,2020-03-07,0,1,0,58,55,1
甘肃,2020-01-27,1,0,0,1,0,0
甘肃,2020-01-29,1,0,0,2,0,0
甘肃,2020-01-31,1,0,0,3,0,0
甘肃,2020-02-02,5,0,0,8,0,0
甘肃,2020-02-03,2,0,0,10,0,0
甘肃,2020-02-06,0,1,0,10,1,0
甘肃,2020-02-08,2,0,0,12,1,0
甘肃,2020-02-11,0,1,0,12,2,0
甘肃,2020-02-12,0,4,0,12,6,0
甘肃,2020-02-14,0,3,0,12,9,0
甘肃,2020-02-17,0,2,0,12,11,0
甘肃,2020-02-19,0,1,0,12,12,0
新疆,2020-01-27,1,0,0,1,0,0
新疆,2020-02-11,0,1,0,1,1,0
新疆,2020-02-14,1,0,0,2,1,0
新疆,2020-02-15,1,0,0,3,1,0
新疆,2020-03-04,0,1,0,3,2,0
新疆,2020-03-07,0,1,0,3,3,0
宁夏,2020-01-27,2,0,0,2,0,0
宁夏,2020-01-28,1,0,0,3,0,0
宁夏,2020-01-29,2,0,0,5,0,0
宁夏,2020-01-31,1,0,0,6,0,0
宁夏,2020-02-01,1,0,0,7,0,0
宁夏,2020-02-05,1,0,0,8,0,0
宁夏,2020-02-06,1,0,0,9,0,0
宁夏,2020-02-08,1,4,0,10,4,0
宁夏,2020-02-09,3,0,0,13,4,0
宁夏,2020-02-10,2,0,0,15,4,0
宁夏,2020-02-11,4,2,0,19,6,0
宁夏,2020-02-12,3,0,0,22,6,0
宁夏,2020-02-13,3,0,0,25,6,0
宁夏,2020-02-14,2,0,0,27,6,0
宁夏,2020-02-18,1,3,0,28,9,0
宁夏,2020-02-21,0,3,0,28,12,0
宁夏,2020-02-23,0,7,0,28,19,0
宁夏,2020-02-24,0,1,0,28,20,0
宁夏,2020-02-25,0,2,0,28,22,0
宁夏,2020-02-26,0,3,0,28,25,0
宁夏,2020-02-27,0,1,0,28,26,0
宁夏,2020-02-29,0,1,0,28,27,0
宁夏,2020-03-11,0,1,0,28,28,0
上海,2020-01-27,3,0,0,3,0,0
上海,2020-01-29,2,0,0,5,0,0
上海,2020-02-01,2,0,0,7,0,0
上海,2020-02-03,4,0,0,11,0,0
上海,2020-02-04,1,0,0,12,0,0
上海,2020-02-05,2,0,0,14,0,0
上海,2020-02-06,1,0,0,15,0,0
上海,2020-02-07,1,0,0,16,0,0
上海,2020-02-08,0,1,0,16,1,0
上海,2020-02-12,1,1,0,17,2,0
上海,2020-02-14,1,2,0,18,4,0
上海,2020-02-17,0,2,0,18,6,0
上海,2020-02-19,0,2,0,18,8,0
上海,2020-02-20,0,1,0,18,9,0
上海,2020-02-21,0,1,0,18,10,0
上海,2020-02-22,0,3,0,18,13,0
上海,2020-02-23,0,2,0,18,15,0
上海,2020-02-29,0,1,0,18,16,0
上海,2020-03-05,0,1,0,18,17,0
江西,2020-01-27,1,0,0,1,0,0
江西,2020-01-29,2,0,0,3,0,0
江西,2020-01-30,1,0,0,4,0,0
江西,2020-02-01,4,0,0,8,0,0
江西,2020-02-04,1,0,0,9,0,0
江西,2020-02-06,1,0,0,10,0,0
江西,2020-02-07,1,0,0,11,0,0
江西,2020-02-08,0,1,0,11,1,0
江西,2020-02-09,1,0,0,12,1,0
江西,2020-02-10,2,0,0,14,1,0
江西,2020-02-11,4,0,0,18,1,0
江西,2020-02-12,0,1,0,18,2,0
江西,2020-02-14,0,1,0,18,3,0
江西,2020-02-19,0,1,0,18,4,0
江西,2020-02-22,0,2,0,18,6,0
江西,2020-02-24,0,4,0,18,10,0
江西,2020-02-26,0,1,0,18,11,0
江西,2020-02-27,0,1,0,18,12,0
江西,2020-03-01,0,3,0,18,15,0
江西,2020-03-03,0,3,0,18,18,0
山东,2020-01-27,2,0,0,2,0,0
山东,2020-01-28,6,0,0,8,0,0
山东,2020-01-30,1,0,0,9,0,0
山东,2020-01-31,2,0,0,11,0,0
山东,2020-02-01,3,0,0,14,0,0
山东,2020-02-02,1,0,0,15,0,0
山东,2020-02-03,1,0,0,16,0,0
山东,2020-02-04,1,0,0,17,0,0
山东,2020-02-06,2,0,0,19,0,0
山东,2020-02-08,2,0,0,21,0,0
山东,2020-02-09,0,1,0,21,1,0
山东,2020-02-10,2,0,0,23,1,0
山东,2020-02-11,0,2,0,23,3,0
山东,2020-02-12,0,1,0,23,4,0
山东,2020-02-14,1,0,0,24,4,0
山东,2020-02-17,0,3,0,24,7,0
山东,2020-02-19,0,3,0,24,10,0
山东,2020-02-20,0,1,0,24,11,0
山东,2020-02-21,0,3,0,24,14,0
山东,2020-02-22,0,1,0,24,15,0
山东,2020-02-23,0,3,0,24,18,0
山东,2020-02-24,0,1,0,24,19,0
山东,2020-02-25,0,1,0,24,20,0
山东,2020-02-26,0,2,0,24,22,0
山东,2020-03-02,0,1,0,24,23,0
山东,2020-03-07,0,1,0,24,24,0
上海,2020-01-27,5,0,0,5,0,0
上海,2020-01-30,1,0,0,6,0,0
上海,2020-02-01,1,0,0,7,0,0
上海,2020-02-03,1,0,0,8,0,0
上海,2020-02-04,1,0,0,9,0,0
上海,2020-02-05,1,0,0,10,0,0
上海,2020-02-06,1,0,0,11,0,0
上海,2020-02-08,0,1,0,11,1,0
上海,2020-02-09,0,1,0,11,2,0
上海,2020-02-10,0,1,0,11,3,0
上海,2020-02-11,1,0,0,12,3,0
上海,2020-02-12,1,0,0,13,3,0
上海,2020-02-15,0,3,0,13,6,0
上海,2020-02-16,0,1,0,13,7,0
上海,2020-02-17,0,1,0,13,8,0
上海,2020-02-20,0,2,0,13,10,0
上海,2020-02-22,0,1,0,13,11,0
上海,2020-02-23,0,1,0,13,12,0
上海,2020-02-25,0,1,0,13,13,0
内蒙古,2020-01-28,1,0,0,1,0,0
内蒙古,2020-01-29,1,0,0,2,0,0
内蒙古,2020-01-31,1,0,0,3,0,0
内蒙古,2020-02-04,1,0,0,4,0,0
内蒙古,2020-02-08,2,0,0,6,0,0
内蒙古,2020-02-14,2,0,0,8,0,0
内蒙古,2020-02-21,0,3,0,8,3,0
内蒙古,2020-02-23,0,3,0,8,6,0
内蒙古,2020-02-29,0,1,0,8,7,0
内蒙古,2020-03-02,0,0,1,8,7,1
四川,2020-01-28,2,0,0,2,0,0
四川,2020-01-29,2,0,0,4,0,0
四川,2020-01-30,1,0,0,5,0,0
四川,2020-01-31,3,0,0,8,0,0
四川,2020-02-02,4,0,0,12,0,0
四川,2020-02-04,3,0,0,15,0,0
四川,2020-02-05,4,0,0,19,0,0
四川,2020-02-06,1,0,0,20,0,0
四川,2020-02-07,1,1,0,21,1,0
四川,2020-02-09,1,0,0,22,1,0
四川,2020-02-13,2,0,0,24,1,0
四川,2020-02-16,0,2,0,24,3,0
四川,2020-02-20,0,7,0,24,10,0
四川,2020-02-26,0,1,0,24,11,0
四川,2020-02-28,0,1,0,24,12,0
四川,2020-03-02,0,4,0,24,16,0
四川,2020-03-03,0,2,0,24,18,0
四川,2020-03-07,0,1,0,24,19,0
四川,2020-03-08,0,1,0,24,20,0
四川,2020-03-10,0,1,0,24,21,0
四川,2020-03-14,0,3,0,24,24,0
海南,2020-01-28,1,0,0,1,0,0
海南,2020-02-04,1,0,0,2,0,0
海南,2020-02-05,1,0,0,3,0,0
海南,2020-02-12,0,1,0,3,1,0
海南,2020-02-15,0,1,0,3,2,0
海南,2020-03-05,0,0,1,3,2,1
四川,2020-01-28,1,0,0,1,0,0
四川,2020-01-29,1,0,0,2,0,0
四川,2020-02-01,3,0,0,5,0,0
四川,2020-02-03,1,0,0,6,0,0
四川,2020-02-09,0,1,0,6,1,0
四川,2020-02-14,0,1,0,6,2,0
四川,2020-02-16,0,1,0,6,3,0
四川,2020-02-18,0,1,0,6,4,0
四川,2020-02-21,0,1,0,6,5,0
四川,2020-02-23,0,1,0,6,6,0
广东,2020-01-28,1,0,0,1,0,0
广东,2020-02-06,1,0,0,2,0,0
广东,2020-02-07,1,0,0,3,0,0
广东,2020-02-16,1,0,0,4,0,0
广东,2020-02-26,0,2,0,4,2,0
广东,2020-04-09,1,0,0,5,2,0
内蒙古,2020-01-28,2,0,0,2,0,0
内蒙古,2020-02-02,2,0,0,4,0,0
内蒙古,2020-02-04,1,0,0,5,0,0
内蒙古,2020-02-06,2,0,0,7,0,0
内蒙古,2020-02-19,0,1,0,7,1,0
内蒙古,2020-02-20,0,1,0,7,2,0
内蒙古,2020-02-28,0,2,0,7,4,0
内蒙古,2020-03-04,0,1,0,7,5,0
内蒙古,2020-03-05,0,1,0,7,6,0
内蒙古,2020-03-16,0,1,0,7,7,0
黑龙江,2020-01-28,1,0,0,1,0,0
黑龙江,2020-01-30,1,0,0,2,0,0
黑龙江,2020-01-31,2,0,0,4,0,0
黑龙江,2020-02-02,2,0,0,6,0,0
黑龙江,2020-02-03,3,0,0,9,0,0
黑龙江,2020-02-04,3,0,0,12,0,0
黑龙江,2020-02-05,9,0,0,21,0,0
黑龙江,2020-02-06,8,0,0,29,0,0
黑龙江,2020-02-07,2,0,0,31,0,0
黑龙江,2020-02-08,3,0,0,34,0,0
黑龙江,2020-02-09,0,1,0,34,1,0
黑龙江,2020-02-10,4,0,0,38,1,0
黑龙江,2020-02-11,5,0,0,43,1,0
黑龙江,2020-02-12,1,0,0,44,1,0
黑龙江,2020-02-14,1,0,0,45,1,0
黑龙江,2020-02-15,1,0,0,46,1,0
黑龙江,2020-02-16,0,1,0,46,2,0
黑龙江,2020-02-18,0,1,0,46,3,0
黑龙江,2020-02-21,0,2,0,46,5,0
黑龙江,2020-02-22,0,9,0,46,14,0
黑龙江,2020-02-23,0,4,0,46,18,0
黑龙江,2020-02-24,0,2,0,46,20,0
黑龙江,2020-02-25,0,2,0,46,22,0
黑龙江,2020-02-26,0,5,0,46,27,0
黑龙江,2020-02-27,0,2,0,46,29,0
黑龙江,2020-02-28,0,1,0,46,30,0
黑龙江,2020-02-29,0,1,0,46,31,0
黑龙江,2020-03-01,0,1,0,46,32,0
黑龙江,2020-03-02,0,3,0,46,35,0
黑龙江,2020-03-03,0,4,0,46,39,0
黑龙江,2020-03-04,0,1,0,46,40,0
黑龙江,2020-03-06,0,1,0,46,41,0
黑龙江,2020-03-09,0,2,0,46,43,0
黑龙江,2020-03-11,0,1,0,46,44,0
黑龙江,2020-03-12,0,1,0,46,45,0
黑龙江,2020-03-14,0,1,0,46,46,0
辽宁,2020-01-28,4,0,0,4,0,0
辽宁,2020-01-31,3,0,0,7,0,0
辽宁,2020-02-06,0,1,0,7,1,0
辽宁,2020-02-07,1,0,0,8,1,0
辽宁,2020-02-08,2,0,0,10,1,0
辽宁,2020-02-09,1,0,0,11,1,0
辽宁,2020-02-11,1,0,0,12,1,0
辽宁,2020-02-14,0,5,0,12,6,0
辽宁,2020-02-15,0,1,0,12,7,0
辽宁,2020-02-20,0,1,0,12,8,0
辽宁,2020-02-22,0,1,0,12,9,0
辽宁,2020-02-25,0,2,0,12,11,0
辽宁,2020-03-03,0,1,0,12,12,0
福建,2020-01-28,1,0,0,1,0,0
福建,2020-02-03,1,0,0,2,0,0
福建,2020-02-06,2,0,0,4,0,0
福建,2020-02-07,1,0,0,5,0,0
福建,2020-02-08,1,0,0,6,0,0
福建,2020-02-10,0,1,0,6,1,0
福建,2020-02-20,0,1,0,6,2,0
福建,2020-02-21,0,1,0,6,3,0
福建,2020-02-22,0,1,0,6,4,0
福建,2020-02-24,0,1,0,6,5,0
福建,2020-02-26,0,1,0,6,6,0
广东,2020-01-28,2,0,0,2,0,0
广东,2020-01-29,1,0,0,3,0,0
广东,2020-02-02,1,0,0,4,0,0
广东,2020-02-03,1,0,0,5,0,0
广东,2020-02-04,1,0,0,6,0,0
广东,2020-02-07,0,1,0,6,1,0
广东,2020-02-08,3,0,0,9,1,0
广东,2020-02-09,1,0,0,10,1,0
广东,2020-02-10,1,0,0,11,1,0
广东,2020-02-11,2,0,0,13,1,0
广东,2020-02-12,0,1,0,13,2,0
广东,2020-02-14,0,1,0,13,3,0
广东,2020-02-16,1,0,0,14,3,0
广东,2020-02-18,0,3,0,14,6,0
广东,2020-02-28,0,1,0,14,7,0
广东,2020-03-01,0,3,0,14,10,0
广东,2020-03-04,0,1,0,14,11,0
广东,2020-03-06,0,3,0,14,14,0
北京,2020-01-28,1,0,0,1,0,0
北京,2020-02-02,2,0,0,3,0,0
北京,2020-06-15,2,0,0,5,0,0
甘肃,2020-01-28,1,0,0,1,0,0
甘肃,2020-02-07,1,0,0,2,0,0
甘肃,2020-02-08,2,0,0,4,0,0
甘肃,2020-02-09,3,0,0,7,0,0
甘肃,2020-02-10,1,0,0,8,0,0
甘肃,2020-02-12,0,1,0,8,1,0
甘肃,2020-02-13,1,0,0,9,1,0
甘肃,2020-02-17,0,2,0,9,3,0
甘肃,2020-02-19,0,1,0,9,4,0
甘肃,2020-02-20,0,2,0,9,6,0
甘肃,2020-03-01,0,2,0,9,8,0
甘肃,2020-03-04,0,1,0,9,9,0
河南,2020-01-28,1,0,0,1,0,0
河南,2020-01-30,2,0,0,3,0,0
河南,2020-02-03,1,0,0,4,0,0
河南,2020-02-05,1,0,0,5,0,0
河南,2020-02-07,2,0,0,7,0,0
河南,2020-02-08,2,0,0,9,0,0
河南,2020-02-09,1,0,0,10,0,0
河南,2020-02-10,1,1,0,11,1,0
河南,2020-02-11,2,0,0,13,1,0
河南,2020-02-14,4,0,0,17,1,0
河南,2020-02-15,0,1,0,17,2,0
河南,2020-02-18,0,3,0,17,5,0
云南,2020-01-28,1,0,0,1,0,0
云南,2020-01-29,2,0,0,3,0,0
云南,2020-01-30,1,0,0,4,0,0
云南,2020-02-15,0,1,0,4,1,0
云南,2020-02-18,0,2,0,4,3,0
云南,2020-02-21,0,1,0,4,4,0
海南,2020-01-28,1,0,0,1,0,0
海南,2020-02-08,0,1,0,1,1,0
吉林,2020-01-28,1,0,0,1,0,0
吉林,2020-02-06,1,0,0,2,0,0
吉林,2020-02-08,2,0,0,4,0,0
吉林,2020-02-13,0,1,0,4,1,0
吉林,2020-02-17,0,1,0,4,2,0
吉林,2020-02-19,1,0,0,5,2,0
吉林,2020-02-23,2,1,0,7,3,0
吉林,2020-02-28,0,1,0,7,4,0
吉林,2020-03-06,0,2,0,7,6,0
吉林,2020-03-15,0,1,0,7,7,0
重庆,2020-01-28,1,0,0,1,0,0
重庆,2020-01-29,1,0,0,2,0,0
重庆,2020-01-30,3,0,0,5,0,0
重庆,2020-01-31,2,0,0,7,0,0
重庆,2020-02-01,2,0,0,9,0,0
重庆,2020-02-03,4,0,0,13,0,0
重庆,2020-02-04,3,0,0,16,0,0
重庆,2020-02-05,1,0,0,17,0,0
重庆,2020-02-06,2,0,0,19,0,0
重庆,2020-02-08,1,1,0,20,1,0
重庆,2020-02-13,0,2,0,20,3,0
重庆,2020-02-14,0,2,0,20,5,0
重庆,2020-02-15,0,2,0,20,7,0
重庆,2020-02-16,0,5,0,20,12,0
重庆,2020-02-18,0,2,0,20,14,0
重庆,2020-02-22,0,1,0,20,15,0
重庆,2020-02-23,0,1,0,20,16,0
重庆,2020-02-27,0,1,0,20,17,0
重庆,2020-03-01,0,1,0,20,18,0
重庆,2020-03-07,0,1,0,20,19,0
重庆,2020-03-09,0,1,0,20,20,0
河北,2020-01-28,1,0,0,1,0,0
河北,2020-01-29,5,0,0,6,0,0
河北,2020-01-31,2,0,0,8,0,0
河北,2020-02-01,1,0,0,9,0,0
河北,2020-02-04,1,0,0,10,0,0
河北,2020-02-05,2,0,0,12,0,0
河北,2020-02-06,1,1,0,13,1,0
河北,2020-02-07,1,0,0,14,1,0
河北,2020-02-09,3,1,0,17,2,0
河北,2020-02-10,4,0,0,21,2,0
河北,2020-02-12,4,1,0,25,3,0
河北,2020-02-13,6,1,0,31,4,0
河北,2020-02-14,2,3,0,33,7,0
河北,2020-02-15,1,2,0,34,9,0
河北,2020-02-18,0,6,0,34,15,0
河北,2020-02-19,0,9,0,34,24,0
河北,2020-02-21,0,1,0,34,25,0
河北,2020-02-22,0,1,0,34,26,0
河北,2020-02-23,0,2,0,34,28,0
河北,2020-02-24,0,4,0,34,32,0
河北,2020-02-25,1,0,0,35,32,0
河北,2020-02-26,5,0,0,40,32,0
河北,2020-02-27,1,1,0,41,33,0
河北,2020-03-01,0,2,0,41,35,0
河北,2020-03-03,0,2,0,41,37,0
河北,2020-03-05,0,1,0,41,38,0
河北,2020-03-12,0,3,0,41,41,0
河北,2020-06-20,2,0,0,43,41,0
贵州,2020-01-29,1,0,0,1,0,0
贵州,2020-01-31,2,0,0,3,0,0
贵州,2020-02-01,1,0,0,4,0,0
贵州,2020-02-03,4,0,0,8,0,0
贵州,2020-02-04,3,0,0,11,0,0
贵州,2020-02-05,2,0,0,13,0,0
贵州,2020-02-07,8,0,0,21,0,0
贵州,2020-02-11,1,2,0,22,2,0
贵州,2020-02-13,1,2,0,23,4,0
贵州,2020-02-14,0,1,0,23,5,0
贵州,2020-02-15,0,1,0,23,6,0
贵州,2020-02-16,0,1,0,23,7,0
贵州,2020-02-17,0,3,0,23,10,0
贵州,2020-02-21,0,3,0,23,13,0
贵州,2020-02-23,0,1,0,23,14,0
贵州,2020-02-25,0,1,0,23,15,0
贵州,2020-03-01,0,1,0,23,16,0
贵州,2020-03-07,0,1,0,23,17,0
贵州,2020-03-08,0,2,0,23,19,0
贵州,2020-03-09,0,1,0,23,20,0
贵州,2020-03-10,0,1,0,23,21,0
贵州,2020-03-12,0,2,0,23,23,0
黑龙江,2020-01-29,1,0,0,1,0,0
黑龙江,2020-01-30,1,0,0,2,0,0
黑龙江,2020-02-16,0,1,0,2,1,0
黑龙江,2020-02-19,0,1,0,2,2,0
黑龙江,2020-03-10,1,0,0,3,2,0
黑龙江,2020-03-23,0,1,0,3,3,0
上海,2020-01-29,3,0,0,3,0,0
上海,2020-02-04,1,0,0,4,0,0
上海,2020-02-05,1,0,0,5,0,0
上海,2020-02-06,2,0,0,7,0,0
上海,2020-02-07,0,1,0,7,1,0
上海,2020-02-11,2,0,0,9,1,0
上海,2020-02-18,0,2,0,9,3,0
上海,2020-02-22,0,2,0,9,5,0
上海,2020-02-24,0,2,0,9,7,0
上海,2020-02-26,0,1,0,9,8,0
上海,2020-03-03,0,1,0,9,9,0
广西,2020-01-29,1,0,0,1,0,0
广西,2020-02-01,2,0,0,3,0,0
广西,2020-02-02,1,0,0,4,0,0
广西,2020-02-20,0,1,0,4,1,0
广西,2020-02-21,0,1,0,4,2,0
广西,2020-02-25,0,2,0,4,4,0
黑龙江,2020-01-29,1,0,0,1,0,0
黑龙江,2020-02-03,1,0,0,2,0,0
黑龙江,2020-02-07,1,0,0,3,0,0
黑龙江,2020-02-08,1,0,0,4,0,0
黑龙江,2020-02-09,1,1,0,5,1,0
黑龙江,2020-02-14,0,1,0,5,2,0
黑龙江,2020-02-22,0,2,0,5,4,0
黑龙江,2020-03-14,0,1,0,5,5,0
北京,2020-01-29,1,0,0,1,0,0
北京,2020-02-02,2,0,0,3,0,0
北京,2020-02-04,1,0,0,4,0,0
北京,2020-02-05,1,0,0,5,0,0
北京,2020-02-06,2,0,0,7,0,0
广东,2020-01-29,1,0,0,1,0,0
广东,2020-01-31,2,0,0,3,0,0
广东,2020-02-02,1,0,0,4,0,0
广东,2020-02-03,2,0,0,6,0,0
广东,2020-02-04,1,0,0,7,0,0
广东,2020-02-05,2,0,0,9,0,0
广东,2020-02-06,2,1,0,11,1,0
广东,2020-02-07,3,0,0,14,1,0
广东,2020-02-08,3,0,0,17,1,0
广东,2020-02-09,2,0,0,19,1,0
广东,2020-02-10,1,1,0,20,2,0
广东,2020-02-11,1,0,0,21,2,0
广东,2020-02-12,1,0,0,22,2,0
广东,2020-02-14,0,1,0,22,3,0
广东,2020-02-15,1,0,0,23,3,0
广东,2020-02-17,0,3,0,23,6,0
广东,2020-02-18,0,2,0,23,8,0
广东,2020-02-19,0,1,0,23,9,0
广东,2020-02-25,0,1,0,23,10,0
广东,2020-02-26,0,1,0,23,11,0
广东,2020-03-03,0,7,0,23,18,0
广东,2020-03-08,0,5,0,23,23,0
上海,2020-01-29,1,0,0,1,0,0
上海,2020-02-04,1,0,0,2,0,0
上海,2020-02-10,1,0,0,3,0,0
上海,2020-02-13,0,1,0,3,1,0
上海,2020-02-14,0,1,0,3,2,0
上海,2020-02-25,0,1,0,3,3,0
上海,2020-02-26,1,0,0,4,3,0
上海,2020-03-05,0,1,0,4,4,0
西藏,2020-01-29,1,0,0,1,0,0
西藏,2020-02-11,0,1,0,1,1,0
宁夏,2020-01-29,1,0,0,1,0,0
宁夏,2020-02-10,0,1,0,1,1,0
贵州,2020-01-29,1,0,0,1,0,0
贵州,2020-01-31,1,0,0,2,0,0
贵州,2020-02-01,2,0,0,4,0,0
贵州,2020-02-04,1,0,0,5,0,0
贵州,2020-02-08,1,0,0,6,0,0
贵州,2020-02-09,2,0,0,8,0,0
贵州,2020-02-10,2,0,0,10,0,0
贵州,2020-02-11,0,1,0,10,1,0
贵州,2020-02-12,0,1,0,10,2,0
贵州,2020-02-14,0,1,0,10,3,0
贵州,2020-02-16,0,1,0,10,4,0
贵州,2020-02-20,0,1,0,10,5,0
贵州,2020-02-21,0,3,0,10,8,0
贵州,2020-02-23,0,1,0,10,9,0
贵州,2020-02-24,0,1,0,10,10,0
广西,2020-01-29,1,0,0,1,0,0
广西,2020-02-01,1,0,0,2,0,0
广西,2020-02-03,1,0,0,3,0,0
广西,2020-02-04,1,0,0,4,0,0
广西,2020-02-05,3,0,0,7,0,0
广西,2020-02-07,1,0,0,8,0,0
广西,2020-02-14,0,1,0,8,1,0
广西,2020-02-20,0,5,0,8,6,0
广西,2020-02-23,0,1,0,8,7,0
广西,2020-03-02,0,1,0,8,8,0
上海,2020-01-29,1,0,0,1,0,0
上海,2020-01-30,2,0,0,3,0,0
上海,2020-02-01,4,0,0,7,0,0
上海,2020-02-04,2,0,0,9,0,0
上海,2020-02-05,1,0,0,10,0,0
上海,2020-02-07,3,0,0,13,0,0
上海,2020-02-08,1,0,0,14,0,0
上海,2020-02-11,0,1,0,14,1,0
上海,2020-02-15,0,1,0,14,2,0
上海,2020-02-17,0,3,0,14,5,0
上海,2020-02-18,0,1,0,14,6,0
上海,2020-02-19,0,1,0,14,7,0
上海,2020-02-22,0,2,0,14,9,0
上海,2020-02-23,0,1,0,14,10,0
上海,2020-02-24,0,1,0,14,11,0
上海,2020-02-29,0,1,0,14,12,0
上海,2020-03-06,0,1,0,14,13,0
上海,2020-03-07,0,1,0,14,14,0
重庆,2020-01-29,1,0,0,1,0,0
重庆,2020-02-15,0,1,0,1,1,0
吉林,2020-01-29,2,0,0,2,0,0
吉林,2020-02-03,1,0,0,3,0,0
吉林,2020-02-05,1,0,0,4,0,0
吉林,2020-02-06,1,0,0,5,0,0
吉林,2020-02-09,0,2,0,5,2,0
吉林,2020-02-18,0,2,0,5,4,0
吉林,2020-02-24,0,1,0,5,5,0
陕西,2020-01-29,1,0,0,1,0,0
陕西,2020-02-05,1,0,0,2,0,0
陕西,2020-02-07,1,0,0,3,0,0
陕西,2020-02-10,0,1,0,3,1,0
陕西,2020-02-21,0,2,0,3,3,0
湖南,2020-01-29,1,0,0,1,0,0
湖南,2020-01-31,1,0,0,2,0,0
湖南,2020-02-01,1,0,0,3,0,0
湖南,2020-02-05,0,2,0,3,2,0
湖南,2020-02-06,2,0,0,5,2,0
湖南,2020-02-10,0,1,0,5,3,0
湖南,2020-02-15,0,1,0,5,4,0
湖南,2020-02-17,0,1,0,5,5,0
贵州,2020-01-29,1,0,0,1,0,0
贵州,2020-01-31,3,0,0,4,0,0
贵州,2020-02-01,1,0,0,5,0,0
贵州,2020-02-02,3,0,0,8,0,0
贵州,2020-02-03,1,0,0,9,0,0
贵州,2020-02-06,3,0,0,12,0,0
贵州,2020-02-07,3,0,0,15,0,0
贵州,2020-02-08,0,1,0,15,1,0
贵州,2020-02-09,4,0,0,19,1,0
贵州,2020-02-10,4,0,0,23,1,0
贵州,2020-02-11,2,0,0,25,1,0
贵州,2020-02-13,3,0,0,28,1,0
贵州,2020-02-14,3,2,0,31,3,0
贵州,2020-02-15,1,0,0,32,3,0
贵州,2020-02-16,0,2,0,32,5,0
贵州,2020-02-17,0,7,0,32,12,0
贵州,2020-02-18,0,3,0,32,15,0
贵州,2020-02-19,0,1,0,32,16,0
贵州,2020-02-20,0,1,0,32,17,0
贵州,2020-02-21,0,1,0,32,18,0
贵州,2020-02-26,0,1,0,32,19,0
贵州,2020-03-06,0,1,0,32,20,0
贵州,2020-03-07,0,1,0,32,21,0
贵州,2020-03-08,0,3,0,32,24,0
贵州,2020-03-09,0,4,0,32,28,0
贵州,2020-03-10,0,1,0,32,29,0
贵州,2020-03-11,0,2,0,32,31,0
贵州,2020-03-13,0,1,0,32,32,0
四川,2020-01-30,1,0,0,1,0,0
四川,2020-02-17,0,1,0,1,1,0
新疆,2020-01-30,1,0,0,1,0,0
新疆,2020-02-13,0,1,0,1,1,0
海南,2020-01-30,1,0,0,1,0,0
海南,2020-02-02,2,0,0,3,0,0
海南,2020-02-06,1,0,0,4,0,0
海南,2020-02-07,1,0,0,5,0,0
海南,2020-02-09,1,0,0,6,0,0
海南,2020-02-11,1,0,0,7,0,0
海南,2020-02-17,0,1,0,7,1,0
海南,2020-02-19,0,1,0,7,2,0
海南,2020-02-22,0,1,0,7,3,0
海南,2020-02-27,0,1,0,7,4,0
海南,2020-02-28,0,2,0,7,6,0
海南,2020-02-29,0,1,0,7,7,0
海南,2020-01-30,1,0,0,1,0,0
海南,2020-02-03,2,0,0,3,0,0
海南,2020-02-12,0,1,1,3,1,1
海南,2020-02-16,0,1,0,3,2,1
四川,2020-01-30,1,0,0,1,0,0
四川,2020-01-31,6,0,0,7,0,0
四川,2020-02-01,2,0,0,9,0,0
四川,2020-02-02,1,0,0,10,0,0
四川,2020-02-04,1,0,0,11,0,0
四川,2020-02-07,1,1,0,12,1,0
四川,2020-02-08,1,0,0,13,1,0
四川,2020-02-09,0,4,0,13,5,0
四川,2020-02-11,0,3,0,13,8,0
四川,2020-02-13,0,1,0,13,9,0
四川,2020-02-15,0,1,0,13,10,0
四川,2020-02-17,3,1,0,16,11,0
四川,2020-02-21,0,2,0,16,13,0
四川,2020-02-22,0,3,0,16,16,0
重庆,2020-01-30,1,0,0,1,0,0
重庆,2020-01-31,1,0,0,2,0,0
重庆,2020-02-02,2,0,0,4,0,0
重庆,2020-02-03,3,0,0,7,0,0
重庆,2020-02-04,1,0,0,8,0,0
重庆,2020-02-14,1,0,0,9,0,0
重庆,2020-02-16,0,3,0,9,3,0
重庆,2020-02-17,0,1,0,9,4,0
重庆,2020-02-18,0,1,0,9,5,0
重庆,2020-02-25,0,1,0,9,6,0
重庆,2020-02-28,0,1,0,9,7,0
重庆,2020-03-09,0,1,0,9,8,0
重庆,2020-03-14,0,1,0,9,9,0
内蒙古,2020-01-30,2,0,0,2,0,0
内蒙古,2020-02-02,1,0,0,3,0,0
内蒙古,2020-02-16,0,1,0,3,1,0
内蒙古,2020-02-26,0,1,0,3,2,0
内蒙古,2020-03-11,0,1,0,3,3,0
上海,2020-01-30,1,0,0,1,0,0
上海,2020-01-31,1,0,0,2,0,0
上海,2020-02-02,2,0,0,4,0,0
上海,2020-02-03,1,0,0,5,0,0
上海,2020-02-04,1,0,0,6,0,0
上海,2020-02-06,1,0,0,7,0,0
上海,2020-02-10,1,0,0,8,0,0
上海,2020-02-13,1,1,0,9,1,0
上海,2020-02-15,0,1,0,9,2,0
上海,2020-02-16,0,1,0,9,3,0
上海,2020-02-19,0,1,0,9,4,0
上海,2020-02-22,0,1,0,9,5,0
上海,2020-02-23,0,1,0,9,6,0
上海,2020-02-24,0,1,0,9,7,0
上海,2020-02-27,0,1,0,9,8,0
上海,2020-02-29,0,1,0,9,9,0
辽宁,2020-01-31,1,0,0,1,0,0
辽宁,2020-02-06,2,0,0,3,0,0
辽宁,2020-02-14,1,0,0,4,0,0
辽宁,2020-02-26,0,1,0,4,1,0
辽宁,2020-02-29,0,1,0,4,2,0
辽宁,2020-03-03,0,1,0,4,3,0
辽宁,2020-03-07,0,1,0,4,4,0
新疆,2020-01-31,1,0,0,1,0,0
新疆,2020-02-01,3,0,0,4,0,0
新疆,2020-02-21,0,0,1,4,0,1
新疆,2020-02-24,0,1,0,4,1,1
新疆,2020-02-28,0,1,0,4,2,1
新疆,2020-03-08,0,1,0,4,3,1
广东,2020-01-31,3,0,0,3,0,0
广东,2020-02-02,1,0,0,4,0,0
广东,2020-02-05,1,0,0,5,0,0
广东,2020-02-15,0,1,0,5,1,0
广东,2020-02-17,0,1,0,5,2,0
广东,2020-02-18,0,2,0,5,4,0
广东,2020-02-28,0,1,0,5,5,0
辽宁,2020-01-31,1,0,0,1,0,0
辽宁,2020-02-01,1,0,0,2,0,0
辽宁,2020-02-02,1,0,0,3,0,0
辽宁,2020-02-03,2,0,0,5,0,0
辽宁,2020-02-04,2,0,0,7,0,0
辽宁,2020-02-10,1,0,0,8,0,0
辽宁,2020-02-16,0,3,0,8,3,0
辽宁,2020-02-18,0,3,0,8,6,0
辽宁,2020-02-24,0,2,0,8,8,0
山西,2020-01-31,2,0,0,2,0,0
山西,2020-02-01,1,0,0,3,0,0
山西,2020-02-02,3,0,0,6,0,0
山西,2020-02-03,1,0,0,7,0,0
山西,2020-02-06,1,0,0,8,0,0
山西,2020-02-08,0,2,0,8,2,0
山西,2020-02-15,1,0,0,9,2,0
山西,2020-02-18,1,0,0,10,2,0
山西,2020-02-19,0,1,0,10,3,0
山西,2020-02-21,0,1,0,10,4,0
山西,2020-02-22,0,1,0,10,5,0
山西,2020-02-26,0,2,0,10,7,0
山西,2020-02-28,0,1,0,10,8,0
山西,2020-03-02,0,1,0,10,9,0
山西,2020-03-03,0,1,0,10,10,0
海南,2020-01-31,1,0,0,1,0,0
海南,2020-02-08,1,0,0,2,0,0
海南,2020-02-20,0,2,0,2,2,0
云南,2020-01-31,1,0,0,1,0,0
云南,2020-02-15,0,1,0,1,1,0
天津,2020-01-31,1,0,0,1,0,0
天津,2020-02-01,1,0,0,2,0,0
天津,2020-02-02,1,0,0,3,0,0
天津,2020-02-03,1,0,0,4,0,0
天津,2020-02-20,0,1,0,4,1,0
天津,2020-02-27,0,1,0,4,2,0
天津,2020-02-29,0,1,0,4,3,0
天津,2020-03-02,0,1,0,4,4,0
上海,2020-01-31,2,0,0,2,0,0
上海,2020-02-01,1,0,0,3,0,0
上海,2020-02-02,1,0,0,4,0,0
上海,2020-02-03,2,0,0,6,0,0
上海,2020-02-06,1,0,0,7,0,0
上海,2020-02-08,1,0,0,8,0,0
上海,2020-02-12,3,0,0,11,0,0
上海,2020-02-14,0,1,0,11,1,0
上海,2020-02-15,0,1,0,11,2,0
上海,2020-02-16,0,1,0,11,3,0
上海,2020-02-17,0,1,0,11,4,0
上海,2020-02-19,0,1,0,11,5,0
上海,2020-02-20,0,1,0,11,6,0
上海,2020-02-21,0,1,0,11,7,0
上海,2020-02-22,0,1,0,11,8,0
上海,2020-02-24,0,1,0,11,9,0
上海,2020-02-29,0,1,0,11,10,0
上海,2020-03-05,0,1,0,11,11,0
河北,2020-01-31,1,0,0,1,0,0
河北,2020-02-02,1,0,0,2,0,0
河北,2020-02-04,1,0,0,3,0,0
河北,2020-02-06,2,0,0,5,0,0
河北,2020-02-07,2,0,0,7,0,0
河北,2020-02-10,2,0,0,9,0,0
河北,2020-02-12,0,1,0,9,1,0
河北,2020-02-13,0,1,0,9,2,0
河北,2020-02-14,1,0,0,10,2,0
河北,2020-02-15,0,1,0,10,3,0
河北,2020-02-18,0,1,0,10,4,0
河北,2020-02-20,0,1,0,10,5,0
河北,2020-02-21,0,1,1,10,6,1
河北,2020-02-23,0,2,0,10,8,1
河北,2020-02-27,0,1,0,10,9,1
重庆,2020-01-31,2,0,0,2,0,0
重庆,2020-02-11,6,0,0,8,0,0
重庆,2020-02-16,0,1,0,8,1,0
重庆,2020-02-23,1,0,0,9,1,0
重庆,2020-02-25,0,1,0,9,2,0
重庆,2020-02-26,0,1,0,9,3,0
重庆,2020-03-02,0,2,0,9,5,0
重庆,2020-03-05,0,2,0,9,7,0
重庆,2020-03-06,0,1,0,9,8,0
重庆,2020-03-12,0,1,0,9,9,0
山西,2020-01-31,1,0,0,1,0,0
山西,2020-02-01,2,0,0,3,0,0
山西,2020-02-07,3,0,0,6,0,0
山西,2020-02-09,1,0,0,7,0,0
山西,2020-02-16,0,1,0,7,1,0
山西,2020-02-18,0,3,0,7,4,0
山西,2020-02-25,0,1,0,7,5,0
山西,2020-02-28,0,1,0,7,6,0
山西,2020-03-03,0,1,0,7,7,0
贵州,2020-02-01,2,0,0,2,0,0
贵州,2020-02-04,1,0,0,3,0,0
贵州,2020-02-06,1,0,0,4,0,0
贵州,2020-02-16,0,1,0,4,1,0
贵州,2020-02-23,0,2,0,4,3,0
贵州,2020-02-26,0,1,0,4,4,0
天津,2020-02-01,3,0,0,3,0,0
天津,2020-02-02,2,0,0,5,0,0
天津,2020-02-03,6,0,0,11,0,0
天津,2020-02-04,2,0,0,13,0,0
天津,2020-02-05,2,0,1,15,0,1
天津,2020-02-06,6,0,0,21,0,1
天津,2020-02-07,2,0,0,23,0,1
天津,2020-02-08,6,0,0,29,0,1
天津,2020-02-09,3,0,0,32,0,1
天津,2020-02-10,3,0,0,35,0,1
天津,2020-02-11,4,1,0,39,1,1
天津,2020-02-12,4,0,0,43,1,1
天津,2020-02-13,3,2,1,46,3,2
天津,2020-02-14,0,4,0,46,7,2
天津,2020-02-15,2,2,0,48,9,2
天津,2020-02-16,1,2,0,49,11,2
天津,2020-02-17,1,1,0,50,12,2
天津,2020-02-18,3,0,0,53,12,2
天津,2020-02-19,2,3,0,55,15,2
天津,2020-02-20,1,2,0,56,17,2
天津,2020-02-21,2,0,0,58,17,2
天津,2020-02-22,2,2,0,60,19,2
天津,2020-02-23,0,7,0,60,26,2
天津,2020-02-24,0,4,0,60,30,2
天津,2020-02-25,0,4,0,60,34,2
天津,2020-02-26,0,5,0,60,39,2
天津,2020-02-27,0,1,0,60,40,2
天津,2020-02-28,0,2,0,60,42,2
天津,2020-02-29,0,3,0,60,45,2
天津,2020-03-02,0,3,0,60,48,2
天津,2020-03-03,0,4,0,60,52,2
天津,2020-03-04,0,4,0,60,56,2
天津,2020-03-09,0,1,0,60,57,2
天津,2020-03-15,0,1,0,60,58,2
上海,2020-02-01,1,0,0,1,0,0
上海,2020-02-04,1,0,0,2,0,0
上海,2020-02-12,1,0,0,3,0,0
上海,2020-02-16,1,0,0,4,0,0
上海,2020-02-18,0,1,0,4,1,0
上海,2020-02-19,0,1,0,4,2,0
上海,2020-02-26,0,1,0,4,3,0
上海,2020-03-04,0,1,0,4,4,0
天津,2020-02-01,3,0,0,3,0,0
天津,2020-02-06,1,0,0,4,0,0
天津,2020-02-13,0,1,0,4,1,0
天津,2020-02-19,0,1,0,4,2,0
天津,2020-02-23,0,2,0,4,4,0
北京,2020-02-01,2,0,0,2,0,0
北京,2020-02-02,2,0,0,4,0,0
北京,2020-02-03,1,0,0,5,0,0
北京,2020-02-04,6,0,0,11,0,0
北京,2020-02-06,2,0,0,13,0,0
北京,2020-02-07,1,0,0,14,0,0
北京,2020-02-15,1,0,0,15,0,0
北京,2020-02-16,1,0,0,16,0,0
北京,2020-06-12,1,0,0,17,0,0
北京,2020-06-13,1,0,0,18,0,0
北京,2020-06-14,1,0,0,19,0,0
北京,2020-06-15,1,0,0,20,0,0
甘肃,2020-02-01,1,0,0,1,0,0
甘肃,2020-02-05,1,0,0,2,0,0
甘肃,2020-02-06,1,0,0,3,0,0
甘肃,2020-02-08,3,0,0,6,0,0
甘肃,2020-02-11,0,1,0,6,1,0
甘肃,2020-02-12,1,0,0,7,1,0
甘肃,2020-02-13,1,1,0,8,2,0
甘肃,2020-02-16,0,2,0,8,4,0
甘肃,2020-02-21,0,2,0,8,6,0
甘肃,2020-02-24,0,2,0,8,8,0
广西,2020-02-01,4,0,0,4,0,0
广西,2020-02-02,1,0,0,5,0,0
广西,2020-02-05,2,0,0,7,0,0
广西,2020-02-09,1,0,0,8,0,0
广西,2020-02-13,0,2,0,8,2,0
广西,2020-02-17,0,1,0,8,3,0
广西,2020-02-24,0,1,0,8,4,0
广西,2020-02-26,0,1,0,8,5,0
广西,2020-02-27,0,1,0,8,6,0
广西,2020-03-01,0,2,0,8,8,0
黑龙江,2020-02-01,1,0,0,1,0,0
黑龙江,2020-02-07,1,0,0,2,0,0
黑龙江,2020-02-09,2,0,0,4,0,0
黑龙江,2020-02-11,2,0,0,6,0,0
黑龙江,2020-02-12,4,0,0,10,0,0
黑龙江,2020-02-13,3,0,0,13,0,0
黑龙江,2020-02-15,1,0,0,14,0,0
黑龙江,2020-02-19,0,3,0,14,3,0
黑龙江,2020-02-21,0,1,0,14,4,0
黑龙江,2020-02-22,0,5,0,14,9,0
黑龙江,2020-02-28,0,1,0,14,10,0
黑龙江,2020-02-29,0,1,0,14,11,0
黑龙江,2020-03-06,0,2,0,14,13,0
黑龙江,2020-03-23,0,1,0,14,14,0
内蒙古,2020-02-01,1,0,0,1,0,0
内蒙古,2020-02-04,1,0,0,2,0,0
内蒙古,2020-02-24,0,1,0,2,1,0
内蒙古,2020-02-27,0,1,0,2,2,0
云南,2020-02-02,2,0,0,2,0,0
云南,2020-02-03,1,0,0,3,0,0
云南,2020-02-04,1,0,0,4,0,0
云南,2020-02-13,0,1,0,4,1,0
云南,2020-02-20,0,1,0,4,2,0
云南,2020-02-21,0,2,0,4,4,0
重庆,2020-02-02,1,0,0,1,0,0
重庆,2020-02-04,1,0,0,2,0,0
重庆,2020-02-05,2,0,0,4,0,0
重庆,2020-02-13,0,1,0,4,1,0
重庆,2020-02-20,0,1,0,4,2,0
重庆,2020-02-24,0,1,0,4,3,0
重庆,2020-02-25,0,1,0,4,4,0
青海,2020-02-02,1,0,0,1,0,0
青海,2020-02-03,2,0,0,3,0,0
青海,2020-02-13,0,2,0,3,2,0
青海,2020-02-21,0,1,0,3,3,0
河南,2020-02-02,2,0,0,2,0,0
河南,2020-02-05,1,0,0,3,0,0
河南,2020-02-06,1,0,0,4,0,0
河南,2020-02-16,1,0,0,5,0,0
河南,2020-02-20,0,1,0,5,1,0
甘肃,2020-02-02,1,0,0,1,0,0
甘肃,2020-02-05,1,0,0,2,0,0
甘肃,2020-02-09,1,0,0,3,0,0
甘肃,2020-02-11,0,1,0,3,1,0
甘肃,2020-02-13,0,1,0,3,2,0
甘肃,2020-03-03,0,1,0,3,3,0
海南,2020-02-02,1,0,0,1,0,0
海南,2020-02-06,2,0,0,3,0,0
海南,2020-02-12,0,1,0,3,1,0
海南,2020-02-18,0,1,0,3,2,0
海南,2020-02-19,0,1,0,3,3,0
北京,2020-02-02,1,0,0,1,0,0
山西,2020-02-02,1,0,0,1,0,0
山西,2020-02-05,1,0,0,2,0,0
山西,2020-02-06,1,0,0,3,0,0
山西,2020-02-15,1,0,0,4,0,0
山西,2020-02-16,0,1,0,4,1,0
山西,2020-02-19,0,1,0,4,2,0
山西,2020-02-22,0,1,0,4,3,0
山西,2020-02-23,0,1,0,4,4,0
新疆,2020-02-03,1,0,0,1,0,0
新疆,2020-02-14,1,0,0,2,0,0
新疆,2020-02-27,0,1,0,2,1,0
新疆,2020-02-28,0,1,0,2,2,0
新疆,2020-02-03,1,0,0,1,0,0
新疆,2020-02-04,1,0,0,2,0,0
新疆,2020-02-09,1,0,0,3,0,0
新疆,2020-02-10,1,0,0,4,0,0
新疆,2020-02-19,0,2,0,4,2,0
新疆,2020-02-22,0,1,0,4,3,0
新疆,2020-03-05,0,1,0,4,4,0
吉林,2020-02-03,3,0,0,3,0,0
吉林,2020-02-05,2,0,0,5,0,0
吉林,2020-02-07,1,0,0,6,0,0
吉林,2020-02-12,0,1,0,6,1,0
吉林,2020-02-14,1,0,0,7,1,0
吉林,2020-02-25,0,1,0,7,2,0
吉林,2020-02-28,0,2,0,7,4,0
吉林,2020-03-01,0,3,0,7,7,0
重庆,2020-02-03,2,0,0,2,0,0
重庆,2020-02-26,0,1,0,2,1,0
重庆,2020-03-06,0,1,0,2,2,0
宁夏,2020-02-03,1,0,0,1,0,0
宁夏,2020-02-11,0,1,0,1,1,0
云南,2020-02-03,1,0,0,1,0,0
云南,2020-02-10,1,0,0,2,0,0
云南,2020-02-21,0,1,0,2,1,0
云南,2020-02-24,0,1,0,2,2,0
海南,2020-02-04,2,0,0,2,0,0
海南,2020-02-08,1,0,0,3,0,0
海南,2020-02-16,0,1,0,3,1,0
海南,2020-02-29,0,2,0,3,3,0
天津,2020-02-04,1,0,0,1,0,0
天津,2020-02-16,0,1,0,1,1,0
天津,2020-02-27,1,0,0,2,1,0
天津,2020-03-10,0,1,0,2,2,0
新疆,2020-02-05,1,0,0,1,0,0
新疆,2020-02-07,1,0,0,2,0,0
新疆,2020-02-08,1,0,0,3,0,0
新疆,2020-02-21,0,2,0,3,2,0
新疆,2020-02-26,0,1,0,3,3,0
广西,2020-02-05,1,0,0,1,0,0
广西,2020-02-06,1,0,0,2,0,0
广西,2020-02-07,1,0,0,3,0,0
广西,2020-02-08,4,0,0,7,0,0
广西,2020-02-09,4,0,0,11,0,0
广西,2020-02-26,0,2,0,11,2,0
广西,2020-02-27,0,1,0,11,3,0
广西,2020-02-28,0,1,0,11,4,0
广西,2020-03-05,0,3,0,11,7,0
广西,2020-03-06,0,1,0,11,8,0
广西,2020-03-09,0,1,0,11,9,0
广西,2020-03-10,0,1,0,11,10,0
广西,2020-03-16,0,1,0,11,11,0
重庆,2020-02-05,1,0,0,1,0,0
重庆,2020-02-28,0,1,0,1,1,0
天津,2020-02-06,1,0,0,1,0,0
天津,2020-02-11,3,0,0,4,0,0
天津,2020-02-12,1,0,0,5,0,0
天津,2020-02-13,1,1,0,6,1,0
天津,2020-02-21,0,1,0,6,2,0
天津,2020-02-23,0,1,0,6,3,0
天津,2020-02-27,0,1,0,6,4,0
天津,2020-02-28,0,1,0,6,5,0
天津,2020-03-08,0,1,0,6,6,0
天津,2020-06-17,1,0,0,7,6,0
重庆,2020-02-06,1,0,0,1,0,0
重庆,2020-02-29,0,1,0,1,1,0
吉林,2020-02-07,1,0,0,1,0,0
吉林,2020-03-05,0,1,0,1,1,0
新疆,2020-02-07,1,0,0,1,0,0
新疆,2020-02-16,2,0,0,3,0,0
新疆,2020-02-24,0,1,0,3,1,0
新疆,2020-02-27,0,2,0,3,3,0
北京,2020-02-07,4,0,0,4,0,0
北京,2020-02-08,1,0,0,5,0,0
北京,2020-02-09,1,0,0,6,0,0
北京,2020-02-11,1,0,0,7,0,0
天津,2020-02-08,1,0,0,1,0,0
天津,2020-02-13,0,1,0,1,1,0
天津,2020-02-14,1,0,0,2,1,0
天津,2020-02-23,0,1,0,2,2,0
新疆,2020-02-09,3,0,0,3,0,0
新疆,2020-02-10,4,0,0,7,0,0
新疆,2020-02-11,2,0,0,9,0,0
新疆,2020-02-12,1,0,0,10,0,0
新疆,2020-02-26,0,1,0,10,1,0
新疆,2020-02-27,0,3,1,10,4,1
新疆,2020-02-28,0,2,0,10,6,1
新疆,2020-02-29,0,3,0,10,9,1
黑龙江,2020-02-14,1,0,0,1,0,0
黑龙江,2020-02-27,0,1,0,1,1,0
江西,2020-02-16,1,0,0,1,0,0
江西,2020-02-26,0,1,0,1,1,0
浙江,2020-02-20,34,0,0,34,0,0
浙江,2020-02-21,2,0,0,36,0,0
浙江,2020-02-25,0,3,0,36,3,0
浙江,2020-02-27,0,2,0,36,5,0
浙江,2020-03-02,0,10,0,36,15,0
浙江,2020-03-05,0,12,0,36,27,0
浙江,2020-03-06,0,2,0,36,29,0
浙江,2020-03-07,0,2,0,36,31,0
浙江,2020-03-08,0,3,0,36,34,0
浙江,2020-03-09,0,2,0,36,36,0
宁夏,2020-02-26,1,0,0,1,0,0
宁夏,2020-02-28,1,0,0,2,0,0
宁夏,2020-03-01,1,0,0,3,0,0
宁夏,2020-03-06,0,2,0,3,2,0
宁夏,2020-03-16,0,1,0,3,3,0
北京,2020-02-29,2,0,0,2,0,0
北京,2020-03-03,2,0,0,4,0,0
北京,2020-03-05,4,0,0,8,0,0
北京,2020-03-06,3,0,0,11,0,0
北京,2020-03-07,2,0,0,13,0,0
北京,2020-03-09,1,0,0,14,0,0
北京,2020-03-10,6,0,0,20,0,0
北京,2020-03-12,1,0,0,21,0,0
北京,2020-03-13,1,0,0,22,0,0
北京,2020-03-14,5,0,0,27,0,0
北京,2020-03-15,4,0,0,31,0,0
北京,2020-03-16,9,0,0,40,0,0
北京,2020-03-17,3,0,0,43,0,0
北京,2020-03-18,21,0,0,64,0,0
北京,2020-03-19,6,0,0,70,0,0
北京,2020-03-20,14,0,0,84,0,0
北京,2020-03-21,13,0,0,97,0,0
北京,2020-03-22,10,0,0,107,0,0
北京,2020-03-23,31,0,0,138,0,0
北京,2020-03-24,5,0,0,143,0,0
北京,2020-03-25,6,0,0,149,0,0
北京,2020-03-26,4,0,0,153,0,0
北京,2020-03-27,3,0,0,156,0,0
北京,2020-03-28,4,0,0,160,0,0
北京,2020-03-29,1,0,0,161,0,0
北京,2020-03-30,3,0,0,164,0,0
北京,2020-04-01,2,0,0,166,0,0
北京,2020-04-02,1,0,0,167,0,0
北京,2020-04-03,2,0,0,169,0,0
北京,2020-04-04,1,0,0,170,0,0
北京,2020-04-05,1,0,0,171,0,0
北京,2020-04-07,1,0,0,172,0,0
北京,2020-04-10,1,0,0,173,0,0
北京,2020-04-14,1,0,0,174,0,0
广东,2020-03-01,1,0,0,1,0,0
广东,2020-03-06,1,0,0,2,0,0
广东,2020-03-09,1,0,0,3,0,0
广东,2020-03-11,3,0,0,6,0,0
广东,2020-03-14,1,0,0,7,0,0
广东,2020-03-15,4,0,0,11,0,0
广东,2020-03-16,3,0,0,14,0,0
广东,2020-03-17,5,0,0,19,0,0
广东,2020-03-18,9,1,0,28,1,0
广东,2020-03-19,14,0,0,42,1,0
广东,2020-03-20,7,0,0,49,1,0
广东,2020-03-21,7,0,0,56,1,0
广东,2020-03-22,6,0,0,62,1,0
广东,2020-03-23,14,0,0,76,1,0
广东,2020-03-24,5,1,0,81,2,0
广东,2020-03-25,11,2,0,92,4,0
广东,2020-03-26,12,0,0,104,4,0
广东,2020-03-27,11,4,0,115,8,0
广东,2020-03-28,8,8,0,123,16,0
广东,2020-03-29,9,2,0,132,18,0
广东,2020-03-30,6,2,0,138,20,0
广东,2020-03-31,10,4,0,148,24,0
广东,2020-04-01,6,8,0,154,32,0
广东,2020-04-02,6,3,0,160,35,0
广东,2020-04-03,2,10,0,162,45,0
广东,2020-04-04,3,6,0,165,51,0
广东,2020-04-05,7,7,0,172,58,0
广东,2020-04-06,1,6,0,173,64,0
广东,2020-04-07,2,10,0,175,74,0
广东,2020-04-08,1,12,0,176,86,0
广东,2020-04-09,2,0,0,178,86,0
广东,2020-04-10,1,0,0,179,86,0
广东,2020-04-11,4,0,0,183,86,0
广东,2020-04-13,6,0,0,189,86,0
广东,2020-04-16,1,0,0,190,86,0
广东,2020-04-19,1,0,0,191,86,0
广东,2020-04-22,1,0,0,192,86,0
广东,2020-04-26,1,0,0,193,86,0
广东,2020-05-06,1,0,0,194,86,0
广东,2020-05-16,1,0,0,195,86,0
广东,2020-05-20,1,0,0,196,86,0
广东,2020-05-23,1,0,0,197,86,0
广东,2020-05-29,1,0,0,198,86,0
广东,2020-05-31,2,0,0,200,86,0
广东,2020-06-01,1,0,0,201,86,0
广东,2020-06-02,1,0,0,202,86,0
广东,2020-06-03,1,0,0,203,86,0
广东,2020-06-05,3,0,0,206,86,0
广东,2020-06-06,1,0,0,207,86,0
广东,2020-06-08,2,0,0,209,86,0
广东,2020-06-09,0,1,0,209,87,0
广东,2020-06-10,3,1,0,212,88,0
广东,2020-06-12,1,0,0,213,88,0
广东,2020-06-13,17,0,0,230,88,0
广东,2020-06-15,3,0,0,233,88,0
广东,2020-06-18,3,0,0,236,88,0
广东,2020-06-19,3,0,0,239,88,0
广东,2020-06-24,1,0,0,240,88,0
浙江,2020-03-01,1,0,0,1,0,0
浙江,2020-03-02,7,0,0,8,0,0
浙江,2020-03-04,2,0,0,10,0,0
浙江,2020-03-13,0,1,0,10,1,0
浙江,2020-03-14,4,0,0,14,1,0
浙江,2020-03-16,1,0,0,15,1,0
浙江,2020-03-18,1,1,0,16,2,0
浙江,2020-03-19,1,2,0,17,4,0
浙江,2020-03-20,2,0,0,19,4,0
浙江,2020-03-21,1,0,0,20,4,0
浙江,2020-03-22,1,1,0,21,5,0
浙江,2020-03-23,2,0,0,23,5,0
浙江,2020-03-24,1,0,0,24,5,0
浙江,2020-03-25,2,1,0,26,6,0
浙江,2020-03-26,3,0,0,29,6,0
浙江,2020-03-27,4,3,0,33,9,0
浙江,2020-03-28,3,0,0,36,9,0
浙江,2020-03-29,1,0,0,37,9,0
浙江,2020-03-30,2,1,0,39,10,0
浙江,2020-04-01,1,2,0,40,12,0
浙江,2020-04-02,2,0,0,42,12,0
浙江,2020-04-03,2,1,0,44,13,0
浙江,2020-04-04,1,1,0,45,14,0
浙江,2020-04-05,1,0,0,46,14,0
浙江,2020-04-06,1,0,0,47,14,0
浙江,2020-04-07,1,2,0,48,16,0
浙江,2020-04-08,1,3,0,49,19,0
浙江,2020-04-10,0,1,0,49,20,0
浙江,2020-04-11,0,2,0,49,22,0
浙江,2020-04-12,0,1,0,49,23,0
浙江,2020-04-13,0,2,0,49,25,0
浙江,2020-04-14,1,2,0,50,27,0
浙江,2020-04-16,0,2,0,50,29,0
浙江,2020-04-18,0,1,0,50,30,0
浙江,2020-04-19,0,2,0,50,32,0
浙江,2020-04-20,0,2,0,50,34,0
浙江,2020-04-21,0,1,0,50,35,0
浙江,2020-04-22,0,2,0,50,37,0
浙江,2020-04-23,0,2,0,50,39,0
浙江,2020-04-25,0,1,0,50,40,0
浙江,2020-04-26,0,1,0,50,41,0
浙江,2020-04-27,0,3,0,50,44,0
浙江,2020-04-28,0,1,0,50,45,0
浙江,2020-04-29,0,1,0,50,46,0
浙江,2020-04-30,0,1,0,50,47,0
浙江,2020-05-01,0,1,0,50,48,0
浙江,2020-05-04,0,2,0,50,50,0
甘肃,2020-03-05,11,0,0,11,0,0
甘肃,2020-03-06,17,0,0,28,0,0
甘肃,2020-03-07,1,0,0,29,0,0
甘肃,2020-03-08,4,0,0,33,0,0
甘肃,2020-03-10,1,0,0,34,0,0
甘肃,2020-03-11,2,0,0,36,0,0
甘肃,2020-03-13,2,1,0,38,1,0
甘肃,2020-03-14,3,1,0,41,2,0
甘肃,2020-03-15,1,0,0,42,2,0
甘肃,2020-03-19,1,7,0,43,9,0
甘肃,2020-03-20,0,15,0,43,24,0
甘肃,2020-03-22,2,1,0,45,25,0
甘肃,2020-03-23,0,4,0,45,29,0
甘肃,2020-03-24,0,1,0,45,30,0
甘肃,2020-03-25,0,2,0,45,32,0
甘肃,2020-03-26,0,2,0,45,34,0
甘肃,2020-03-27,0,2,0,45,36,0
甘肃,2020-03-29,1,0,0,46,36,0
甘肃,2020-04-01,0,2,0,46,38,0
甘肃,2020-04-03,0,4,0,46,42,0
甘肃,2020-04-05,1,0,0,47,42,0
甘肃,2020-04-07,0,1,0,47,43,0
甘肃,2020-04-08,0,2,0,47,45,0
甘肃,2020-04-14,0,1,0,47,46,0
甘肃,2020-04-16,0,1,0,47,47,0
甘肃,2020-06-16,10,0,0,57,47,0
甘肃,2020-06-17,1,0,0,58,47,0
甘肃,2020-06-18,1,0,0,59,47,0
甘肃,2020-06-22,7,0,0,66,47,0
甘肃,2020-06-23,0,1,0,66,48,0
甘肃,2020-06-24,3,0,0,69,48,0
甘肃,2020-06-25,0,1,0,69,49,0
甘肃,2020-06-26,1,0,0,70,49,0
甘肃,2020-06-27,1,1,0,71,50,0
上海,2020-03-05,1,0,0,1,0,0
上海,2020-03-06,3,0,0,4,0,0
上海,2020-03-10,2,0,0,6,0,0
上海,2020-03-12,2,0,0,8,0,0
上海,2020-03-13,4,0,0,12,0,0
上海,2020-03-14,3,0,0,15,0,0
上海,2020-03-15,2,0,0,17,0,0
上海,2020-03-16,3,0,0,20,0,0
上海,2020-03-17,3,0,0,23,0,0
上海,2020-03-18,2,1,0,25,1,0
上海,2020-03-19,8,0,0,33,1,0
上海,2020-03-20,9,0,0,42,1,0
上海,2020-03-21,14,0,0,56,1,0
上海,2020-03-22,10,0,0,66,1,0
上海,2020-03-23,9,1,0,75,2,0
上海,2020-03-24,19,1,0,94,3,0
上海,2020-03-25,18,0,0,112,3,0
上海,2020-03-26,17,1,0,129,4,0
上海,2020-03-27,17,3,0,146,7,0
上海,2020-03-28,7,0,0,153,7,0
上海,2020-03-29,6,0,0,159,7,0
上海,2020-03-30,11,4,0,170,11,0
上海,2020-03-31,7,3,0,177,14,0
上海,2020-04-01,6,2,0,183,16,0
上海,2020-04-02,4,0,0,187,16,0
上海,2020-04-03,3,5,0,190,21,0
上海,2020-04-04,2,8,0,192,29,0
上海,2020-04-05,5,26,0,197,55,0
上海,2020-04-06,2,6,0,199,61,0
上海,2020-04-07,5,17,0,204,78,0
上海,2020-04-08,9,11,0,213,89,0
上海,2020-04-09,3,5,0,216,94,0
上海,2020-04-10,0,13,0,216,107,0
上海,2020-04-11,52,3,0,268,110,0
上海,2020-04-12,11,8,0,279,118,0
上海,2020-04-13,0,12,0,279,130,0
上海,2020-04-14,4,10,0,283,140,0
上海,2020-04-15,6,15,0,289,155,0
上海,2020-04-16,0,4,0,289,159,0
上海,2020-04-17,0,22,0,289,181,0
上海,2020-04-18,7,4,0,296,185,0
上海,2020-04-19,3,5,0,299,190,0
上海,2020-04-20,0,9,0,299,199,0
上海,2020-04-21,1,0,0,300,199,0
上海,2020-04-22,1,2,0,301,201,0
上海,2020-04-23,1,1,0,302,202,0
上海,2020-04-24,0,14,0,302,216,0
上海,2020-04-25,1,11,0,303,227,0
上海,2020-04-26,0,10,0,303,237,0
上海,2020-04-27,2,13,0,305,250,0
上海,2020-04-28,1,3,0,306,253,0
上海,2020-04-29,2,13,0,308,266,0
上海,2020-04-30,5,2,0,313,268,0
上海,2020-05-01,0,13,0,313,281,0
上海,2020-05-02,1,0,0,314,281,0
上海,2020-05-03,2,2,0,316,283,0
上海,2020-05-04,1,4,0,317,287,0
上海,2020-05-05,0,1,0,317,288,0
上海,2020-05-06,1,0,0,318,288,0
上海,2020-05-07,0,3,0,318,291,0
上海,2020-05-09,2,3,0,320,294,0
上海,2020-05-10,0,1,0,320,295,0
上海,2020-05-12,1,4,0,321,299,0
上海,2020-05-13,0,2,0,321,301,0
上海,2020-05-14,0,5,0,321,306,0
上海,2020-05-15,5,2,0,326,308,0
上海,2020-05-16,0,1,0,326,309,0
上海,2020-05-19,0,1,0,326,310,0
上海,2020-05-20,0,3,0,326,313,0
上海,2020-05-21,0,1,0,326,314,0
上海,2020-05-22,0,1,0,326,315,0
上海,2020-05-23,1,0,0,327,315,0
上海,2020-05-24,0,1,0,327,316,0
上海,2020-05-25,1,4,0,328,320,0
上海,2020-05-26,1,1,0,329,321,0
上海,2020-05-27,1,1,0,330,322,0
上海,2020-05-29,1,2,0,331,324,0
上海,2020-06-01,1,2,0,332,326,0
上海,2020-06-02,0,1,0,332,327,0
上海,2020-06-04,4,1,0,336,328,0
上海,2020-06-05,0,1,0,336,329,0
上海,2020-06-06,0,1,0,336,330,0
上海,2020-06-07,1,0,0,337,330,0
上海,2020-06-09,0,1,0,337,331,0
上海,2020-06-10,6,0,0,343,331,0
上海,2020-06-11,5,1,0,348,332,0
上海,2020-06-12,1,0,0,349,332,0
上海,2020-06-13,1,0,0,350,332,0
上海,2020-06-14,1,1,0,351,333,0
上海,2020-06-15,3,0,0,354,333,0
上海,2020-06-17,2,1,0,356,334,0
上海,2020-06-19,1,0,0,357,334,0
上海,2020-06-21,3,0,0,360,334,0
上海,2020-06-22,0,1,0,360,335,0
上海,2020-06-23,2,0,0,362,335,0
上海,2020-06-24,0,1,0,362,336,0
上海,2020-06-25,2,2,0,364,338,0
上海,2020-06-26,1,2,0,365,340,0
上海,2020-06-27,1,1,0,366,341,0
上海,2020-06-28,1,0,0,367,341,0
上海,2020-06-29,4,0,0,371,341,0
山东,2020-03-10,1,0,0,1,0,0
山东,2020-03-16,1,0,0,2,0,0
山东,2020-03-19,1,0,0,3,0,0
山东,2020-03-20,2,0,0,5,0,0
山东,2020-03-21,1,0,0,6,0,0
山东,2020-03-22,2,0,0,8,0,0
山东,2020-03-23,1,0,0,9,0,0
山东,2020-03-24,1,0,0,10,0,0
山东,2020-03-26,2,0,0,12,0,0
山东,2020-03-27,1,0,0,13,0,0
山东,2020-03-29,1,1,0,14,1,0
山东,2020-03-30,1,0,0,15,1,0
山东,2020-04-01,1,0,0,16,1,0
山东,2020-04-02,3,1,0,19,2,0
山东,2020-04-03,0,1,0,19,3,0
山东,2020-04-04,1,0,0,20,3,0
山东,2020-04-05,1,0,0,21,3,0
山东,2020-04-06,1,0,0,22,3,0
山东,2020-04-08,0,1,0,22,4,0
山东,2020-04-10,1,1,0,23,5,0
山东,2020-04-12,0,1,0,23,6,0
山东,2020-04-13,0,1,0,23,7,0
山东,2020-04-14,0,2,0,23,9,0
山东,2020-04-16,1,0,0,24,9,0
山东,2020-04-17,0,4,0,24,13,0
山东,2020-04-21,0,1,0,24,14,0
山东,2020-04-24,0,1,0,24,15,0
山东,2020-04-26,0,1,0,24,16,0
山东,2020-04-28,0,3,0,24,19,0
山东,2020-04-29,0,1,0,24,20,0
山东,2020-05-03,1,1,0,25,21,0
山东,2020-05-05,0,1,0,25,22,0
山东,2020-05-07,0,1,0,25,23,0
山东,2020-05-14,0,1,0,25,24,0
山东,2020-05-29,2,0,0,27,24,0
山东,2020-05-30,2,0,0,29,24,0
山东,2020-06-07,0,1,0,29,25,0
山东,2020-06-13,0,1,0,29,26,0
山东,2020-06-15,0,1,0,29,27,0
山东,2020-06-19,0,2,0,29,29,0
河南,2020-03-11,1,0,0,1,0,0
河南,2020-03-22,1,0,0,2,0,0
河南,2020-03-25,1,0,0,3,0,0
河南,2020-03-27,0,1,0,3,1,0
河南,2020-04-05,0,1,0,3,2,0
河南,2020-04-11,0,1,0,3,3,0
云南,2020-03-15,1,0,0,1,0,0
云南,2020-03-16,1,0,0,2,0,0
云南,2020-03-25,2,0,0,4,0,0
云南,2020-03-26,2,0,0,6,0,0
云南,2020-03-30,1,0,0,7,0,0
云南,2020-03-31,1,0,0,8,0,0
云南,2020-04-01,1,0,0,9,0,0
云南,2020-04-02,1,0,0,10,0,0
云南,2020-04-06,0,1,0,10,1,0
云南,2020-04-10,0,1,0,10,2,0
云南,2020-04-13,0,1,0,10,3,0
云南,2020-04-14,0,1,0,10,4,0
云南,2020-04-16,0,1,0,10,5,0
云南,2020-04-18,0,1,0,10,6,0
云南,2020-04-23,0,2,0,10,8,0
云南,2020-04-24,1,0,0,11,8,0
云南,2020-04-25,0,1,0,11,9,0
云南,2020-05-07,0,1,0,11,10,0
云南,2020-05-09,0,1,0,11,11,0
广西,2020-03-16,1,0,0,1,0,0
广西,2020-03-19,1,0,0,2,0,0
广西,2020-04-01,0,2,0,2,2,0
陕西,2020-03-16,1,0,0,1,0,0
陕西,2020-03-20,2,0,0,3,0,0
陕西,2020-03-24,1,0,0,4,0,0
陕西,2020-03-25,3,0,0,7,0,0
陕西,2020-03-26,1,0,0,8,0,0
陕西,2020-03-31,2,0,0,10,0,0
陕西,2020-04-02,0,2,0,10,2,0
陕西,2020-04-03,1,1,0,11,3,0
陕西,2020-04-05,0,1,0,11,4,0
陕西,2020-04-10,0,2,0,11,6,0
陕西,2020-04-14,0,3,0,11,9,0
陕西,2020-04-16,0,1,0,11,10,0
陕西,2020-04-20,21,1,0,32,11,0
陕西,2020-04-21,2,0,0,34,11,0
陕西,2020-04-24,7,0,0,41,11,0
陕西,2020-04-27,20,0,0,61,11,0
陕西,2020-04-30,0,1,0,61,12,0
陕西,2020-05-01,0,1,0,61,13,0
陕西,2020-05-02,0,5,0,61,18,0
陕西,2020-05-03,0,3,0,61,21,0
陕西,2020-05-05,2,1,0,63,22,0
陕西,2020-05-06,0,2,0,63,24,0
陕西,2020-05-07,0,2,0,63,26,0
陕西,2020-05-08,0,24,0,63,50,0
陕西,2020-05-09,0,1,0,63,51,0
陕西,2020-05-10,0,1,0,63,52,0
陕西,2020-05-11,0,2,0,63,54,0
陕西,2020-05-12,0,1,0,63,55,0
陕西,2020-05-14,0,3,0,63,58,0
陕西,2020-05-15,0,1,0,63,59,0
陕西,2020-05-18,0,2,0,63,61,0
陕西,2020-05-22,0,1,0,63,62,0
陕西,2020-05-23,0,1,0,63,63,0
陕西,2020-06-01,1,0,0,64,63,0
陕西,2020-06-06,2,0,0,66,63,0
陕西,2020-06-10,0,1,0,66,64,0
陕西,2020-06-13,2,0,0,68,64,0
陕西,2020-06-16,1,0,0,69,64,0
陕西,2020-06-20,2,0,0,71,64,0
陕西,2020-06-21,1,0,0,72,64,0
陕西,2020-06-22,0,1,0,72,65,0
陕西,2020-06-23,2,0,0,74,65,0
陕西,2020-06-27,1,0,0,75,65,0
陕西,2020-06-29,0,1,0,75,66,0
陕西,2020-06-30,0,1,0,75,67,0
四川,2020-03-17,1,0,0,1,0,0
四川,2020-03-19,1,0,0,2,0,0
四川,2020-03-20,1,0,0,3,0,0
四川,2020-03-21,1,0,0,4,0,0
四川,2020-03-23,2,0,0,6,0,0
四川,2020-03-24,2,0,0,8,0,0
四川,2020-03-26,1,0,0,9,0,0
四川,2020-03-28,2,0,0,11,0,0
四川,2020-03-31,2,0,0,13,0,0
四川,2020-04-01,2,1,0,15,1,0
四川,2020-04-02,1,0,0,16,1,0
四川,2020-04-03,2,1,0,18,2,0
四川,2020-04-04,1,1,0,19,3,0
四川,2020-04-05,1,1,0,20,4,0
四川,2020-04-06,1,1,0,21,5,0
四川,2020-04-09,0,5,0,21,10,0
四川,2020-04-10,0,1,0,21,11,0
四川,2020-04-12,0,1,0,21,12,0
四川,2020-04-14,0,2,0,21,14,0
四川,2020-04-15,0,2,0,21,16,0
四川,2020-04-17,0,1,0,21,17,0
四川,2020-04-18,0,1,0,21,18,0
四川,2020-04-21,0,2,0,21,20,0
四川,2020-04-22,0,1,0,21,21,0
四川,2020-05-21,2,0,0,23,21,0
四川,2020-05-24,1,0,0,24,21,0
四川,2020-05-31,11,0,0,35,21,0
四川,2020-06-01,2,0,0,37,21,0
四川,2020-06-04,1,0,0,38,21,0
四川,2020-06-07,3,0,0,41,21,0
四川,2020-06-08,1,0,0,42,21,0
四川,2020-06-10,0,2,0,42,23,0
四川,2020-06-11,0,1,0,42,24,0
四川,2020-06-12,1,1,0,43,25,0
四川,2020-06-13,0,1,0,43,26,0
四川,2020-06-14,4,0,0,47,26,0
四川,2020-06-15,0,1,0,47,27,0
四川,2020-06-16,1,1,0,48,28,0
四川,2020-06-17,0,2,0,48,30,0
四川,2020-06-18,0,2,0,48,32,0
四川,2020-06-19,0,1,0,48,33,0
四川,2020-06-22,0,2,0,48,35,0
四川,2020-06-23,0,1,0,48,36,0
四川,2020-06-24,0,2,0,48,38,0
四川,2020-06-28,3,2,0,51,40,0
四川,2020-06-29,3,1,0,54,41,0
四川,2020-06-30,0,2,0,54,43,0
黑龙江,2020-03-18,1,0,0,1,0,0
黑龙江,2020-03-19,1,0,0,2,0,0
黑龙江,2020-04-01,4,0,0,6,0,0
黑龙江,2020-04-02,1,0,0,7,0,0
黑龙江,2020-04-03,2,0,0,9,0,0
黑龙江,2020-04-04,13,0,0,22,0,0
黑龙江,2020-04-05,20,0,0,42,0,0
黑龙江,2020-04-06,20,0,0,62,0,0
黑龙江,2020-04-07,25,1,0,87,1,0
黑龙江,2020-04-08,40,0,0,127,1,0
黑龙江,2020-04-09,28,0,0,155,1,0
黑龙江,2020-04-10,22,0,0,177,1,0
黑龙江,2020-04-11,21,0,0,198,1,0
黑龙江,2020-04-12,49,0,0,247,1,0
黑龙江,2020-04-13,79,0,0,326,1,0
黑龙江,2020-04-14,14,0,0,340,1,0
黑龙江,2020-04-15,16,1,0,356,2,0
黑龙江,2020-04-16,8,0,0,364,2,0
黑龙江,2020-04-17,13,0,0,377,2,0
黑龙江,2020-04-19,4,0,0,381,2,0
黑龙江,2020-04-20,2,3,0,383,5,0
黑龙江,2020-04-21,1,2,0,384,7,0
黑龙江,2020-04-22,1,8,0,385,15,0
黑龙江,2020-04-24,1,23,0,386,38,0
黑龙江,2020-04-25,0,3,0,386,41,0
黑龙江,2020-04-26,0,45,0,386,86,0
黑龙江,2020-04-27,0,30,0,386,116,0
黑龙江,2020-05-01,0,17,0,386,133,0
黑龙江,2020-05-02,0,3,0,386,136,0
黑龙江,2020-05-03,0,37,0,386,173,0
黑龙江,2020-05-04,0,54,0,386,227,0
黑龙江,2020-05-05,0,34,0,386,261,0
黑龙江,2020-05-06,0,23,0,386,284,0
黑龙江,2020-05-07,0,13,0,386,297,0
黑龙江,2020-05-08,0,12,0,386,309,0
黑龙江,2020-05-09,0,46,0,386,355,0
黑龙江,2020-05-10,0,13,0,386,368,0
黑龙江,2020-05-11,0,14,0,386,382,0
黑龙江,2020-05-12,0,4,0,386,386,0
福建,2020-03-19,3,0,0,3,0,0
福建,2020-03-20,4,0,0,7,0,0
福建,2020-03-21,4,0,0,11,0,0
福建,2020-03-22,6,0,0,17,0,0
福建,2020-03-23,5,0,0,22,0,0
福建,2020-03-24,4,0,0,26,0,0
福建,2020-03-25,6,0,0,32,0,0
福建,2020-03-26,3,0,0,35,0,0
福建,2020-03-27,6,0,0,41,0,0
福建,2020-03-28,1,0,0,42,0,0
福建,2020-03-29,2,0,0,44,0,0
福建,2020-03-30,3,0,0,47,0,0
福建,2020-03-31,2,2,0,49,2,0
福建,2020-04-01,0,2,0,49,4,0
福建,2020-04-02,4,1,0,53,5,0
福建,2020-04-03,1,1,0,54,6,0
福建,2020-04-04,0,2,0,54,8,0
福建,2020-04-05,0,2,0,54,10,0
福建,2020-04-06,1,0,0,55,10,0
福建,2020-04-07,0,2,0,55,12,0
福建,2020-04-08,0,1,0,55,13,0
福建,2020-04-09,0,3,0,55,16,0
福建,2020-04-10,0,6,0,55,22,0
福建,2020-04-11,1,4,0,56,26,0
福建,2020-04-12,0,4,0,56,30,0
福建,2020-04-13,1,4,0,57,34,0
福建,2020-04-14,0,2,0,57,36,0
福建,2020-04-15,0,2,0,57,38,0
福建,2020-04-16,1,1,0,58,39,0
福建,2020-04-17,1,2,0,59,41,0
福建,2020-04-18,0,3,0,59,44,0
福建,2020-04-20,0,2,0,59,46,0
福建,2020-04-21,0,1,0,59,47,0
福建,2020-04-23,0,4,0,59,51,0
福建,2020-04-24,0,3,0,59,54,0
福建,2020-04-28,0,3,0,59,57,0
福建,2020-04-29,0,1,0,59,58,0
福建,2020-04-30,1,0,0,60,58,0
福建,2020-05-06,0,1,0,60,59,0
福建,2020-05-14,0,1,0,60,60,0
福建,2020-05-25,1,0,0,61,60,0
福建,2020-05-27,1,0,0,62,60,0
福建,2020-05-31,0,1,0,62,61,0
福建,2020-06-06,1,0,0,63,61,0
福建,2020-06-10,1,0,0,64,61,0
福建,2020-06-11,1,0,0,65,61,0
福建,2020-06-14,1,0,0,66,61,0
福建,2020-06-18,0,1,0,66,62,0
福建,2020-06-20,1,0,0,67,62,0
辽宁,2020-03-19,1,0,0,1,0,0
辽宁,2020-03-22,1,1,0,2,1,0
辽宁,2020-03-26,1,0,0,3,1,0
辽宁,2020-03-27,3,0,0,6,1,0
辽宁,2020-03-28,3,0,0,9,1,0
辽宁,2020-03-29,2,0,0,11,1,0
辽宁,2020-03-30,3,0,0,14,1,0
辽宁,2020-03-31,1,0,0,15,1,0
辽宁,2020-04-03,2,3,0,17,4,0
辽宁,2020-04-04,1,1,0,18,5,0
辽宁,2020-04-05,0,2,0,18,7,0
辽宁,2020-04-06,2,2,0,20,9,0
辽宁,2020-04-07,0,1,0,20,10,0
辽宁,2020-04-09,0,1,0,20,11,0
辽宁,2020-04-10,1,1,0,21,12,0
辽宁,2020-04-11,0,3,0,21,15,0
辽宁,2020-04-13,0,2,0,21,17,0
辽宁,2020-04-16,0,2,0,21,19,0
辽宁,2020-04-17,0,2,0,21,21,0
辽宁,2020-06-15,1,0,0,22,21,0
辽宁,2020-06-21,1,0,0,23,21,0
辽宁,2020-06-28,1,0,0,24,21,0
辽宁,2020-06-30,0,1,0,24,22,0
天津,2020-03-19,1,0,0,1,0,0
天津,2020-03-23,4,0,0,5,0,0
天津,2020-03-24,4,0,0,9,0,0
天津,2020-03-25,2,0,0,11,0,0
天津,2020-03-26,5,0,0,16,0,0
天津,2020-03-27,4,0,0,20,0,0
天津,2020-03-28,7,0,0,27,0,0
天津,2020-03-29,3,0,0,30,0,0
天津,2020-03-30,8,0,0,38,0,0
天津,2020-03-31,0,2,0,38,2,0
天津,2020-04-01,2,0,0,40,2,0
天津,2020-04-02,1,5,0,41,7,0
天津,2020-04-03,3,0,0,44,7,0
天津,2020-04-04,0,4,0,44,11,0
天津,2020-04-06,0,7,0,44,18,0
天津,2020-04-07,0,1,0,44,19,0
天津,2020-04-08,1,0,0,45,19,0
天津,2020-04-09,1,2,0,46,21,0
天津,2020-04-10,1,4,0,47,25,0
天津,2020-04-11,0,3,0,47,28,0
天津,2020-04-12,1,0,0,48,28,0
天津,2020-04-13,0,3,0,48,31,0
天津,2020-04-14,1,4,0,49,35,0
天津,2020-04-15,0,3,0,49,38,0
天津,2020-04-16,1,1,0,50,39,0
天津,2020-04-17,3,1,0,53,40,0
天津,2020-04-19,0,1,0,53,41,0
天津,2020-04-21,0,2,0,53,43,0
天津,2020-04-22,0,2,0,53,45,0
天津,2020-04-23,0,1,0,53,46,0
天津,2020-04-24,1,3,0,54,49,0
天津,2020-04-25,0,1,0,54,50,0
天津,2020-04-28,0,1,0,54,51,0
天津,2020-04-30,0,1,0,54,52,0
天津,2020-05-01,0,1,0,54,53,0
天津,2020-05-02,0,1,0,54,54,0
天津,2020-05-08,1,0,0,55,54,0
天津,2020-05-13,0,1,0,55,55,0
天津,2020-05-16,1,0,0,56,55,0
天津,2020-06-04,0,1,0,56,56,0
天津,2020-06-06,1,0,0,57,56,0
天津,2020-06-09,1,0,0,58,56,0
天津,2020-06-10,1,0,0,59,56,0
天津,2020-06-12,1,0,0,60,56,0
河北,2020-03-21,1,0,0,1,0,0
河北,2020-03-29,2,0,0,3,0,0
河北,2020-03-31,2,0,0,5,0,0
河北,2020-04-01,2,0,0,7,0,0
河北,2020-04-02,1,0,0,8,0,0
河北,2020-04-04,1,0,0,9,0,0
河北,2020-04-07,0,2,0,9,2,0
河北,2020-04-08,0,1,0,9,3,0
河北,2020-04-15,1,1,0,10,4,0
河北,2020-04-19,0,1,0,10,5,0
河北,2020-04-24,0,1,0,10,6,0
河北,2020-05-04,0,2,0,10,8,0
河北,2020-05-09,0,1,0,10,9,0
河北,2020-05-17,0,1,0,10,10,0
江苏,2020-03-21,2,0,0,2,0,0
江苏,2020-03-23,3,0,0,5,0,0
江苏,2020-03-24,2,0,0,7,0,0
江苏,2020-03-25,2,0,0,9,0,0
江苏,2020-03-26,1,0,0,10,0,0
江苏,2020-03-28,3,0,0,13,0,0
江苏,2020-03-29,1,0,0,14,0,0
江苏,2020-03-30,1,0,0,15,0,0
江苏,2020-04-01,1,0,0,16,0,0
江苏,2020-04-02,4,1,0,20,1,0
江苏,2020-04-04,0,1,0,20,2,0
江苏,2020-04-09,0,1,0,20,3,0
江苏,2020-04-10,1,2,0,21,5,0
江苏,2020-04-11,1,2,0,22,7,0
江苏,2020-04-13,0,3,0,22,10,0
江苏,2020-04-14,0,1,0,22,11,0
江苏,2020-04-16,0,1,0,22,12,0
江苏,2020-04-20,0,1,0,22,13,0
江苏,2020-04-21,0,1,0,22,14,0
江苏,2020-04-23,0,1,0,22,15,0
江苏,2020-04-28,0,1,0,22,16,0
江苏,2020-04-29,0,1,0,22,17,0
江苏,2020-04-30,0,2,0,22,19,0
江苏,2020-05-06,0,1,0,22,20,0
江苏,2020-05-07,0,1,0,22,21,0
江苏,2020-05-10,0,1,0,22,22,0
江西,2020-03-21,1,0,0,1,0,0
江西,2020-03-28,1,0,0,2,0,0
江西,2020-03-29,0,1,0,2,1,0
江西,2020-04-09,0,1,0,2,2,0
重庆,2020-03-22,1,0,0,1,0,0
重庆,2020-03-23,1,0,0,2,0,0
重庆,2020-03-28,1,0,0,3,0,0
重庆,2020-04-23,0,3,0,3,3,0
重庆,2020-06-13,1,0,0,4,3,0
重庆,2020-06-14,2,0,0,6,3,0
山西,2020-03-23,1,0,0,1,0,0
山西,2020-03-25,1,0,0,2,0,0
山西,2020-03-28,1,0,0,3,0,0
山西,2020-03-31,1,0,0,4,0,0
山西,2020-04-04,1,0,0,5,0,0
山西,2020-04-07,25,1,0,30,1,0
山西,2020-04-08,3,0,0,33,1,0
山西,2020-04-09,2,0,0,35,1,0
山西,2020-04-10,4,1,0,39,2,0
山西,2020-04-12,1,0,0,40,2,0
山西,2020-04-14,13,0,0,53,2,0
山西,2020-04-15,8,0,0,61,2,0
山西,2020-04-16,3,0,0,64,2,0
山西,2020-04-20,0,5,0,64,7,0
山西,2020-04-22,0,2,0,64,9,0
山西,2020-04-24,0,7,0,64,16,0
山西,2020-04-25,0,5,0,64,21,0
山西,2020-04-26,0,3,0,64,24,0
山西,2020-04-27,0,3,0,64,27,0
山西,2020-04-29,0,4,0,64,31,0
山西,2020-04-30,0,8,0,64,39,0
山西,2020-05-01,0,4,0,64,43,0
山西,2020-05-03,0,4,0,64,47,0
山西,2020-05-04,0,10,0,64,57,0
山西,2020-05-05,0,3,0,64,60,0
山西,2020-05-06,0,1,0,64,61,0
山西,2020-05-07,0,1,0,64,62,0
山西,2020-05-08,0,1,0,64,63,0
山西,2020-05-12,0,1,0,64,64,0
吉林,2020-03-24,1,0,0,1,0,0
吉林,2020-03-25,1,0,0,2,0,0
吉林,2020-03-27,2,0,0,4,0,0
吉林,2020-03-28,1,0,0,5,0,0
吉林,2020-04-08,0,1,0,5,1,0
吉林,2020-04-09,0,2,0,5,3,0
吉林,2020-04-10,0,1,0,5,4,0
吉林,2020-04-11,1,0,0,6,4,0
吉林,2020-04-12,1,0,0,7,4,0
吉林,2020-04-14,2,0,0,9,4,0
吉林,2020-04-16,0,1,0,9,5,0
吉林,2020-04-18,2,0,0,11,5,0
吉林,2020-04-20,2,0,0,13,5,0
吉林,2020-04-21,0,1,0,13,6,0
吉林,2020-04-22,1,0,0,14,6,0
吉林,2020-04-23,1,1,0,15,7,0
吉林,2020-04-24,1,0,0,16,7,0
吉林,2020-04-26,1,0,0,17,7,0
吉林,2020-04-29,1,0,0,18,7,0
吉林,2020-04-30,0,2,0,18,9,0
吉林,2020-05-01,1,1,0,19,10,0
吉林,2020-05-02,0,1,0,19,11,0
吉林,2020-05-07,0,1,0,19,12,0
吉林,2020-05-08,0,1,0,19,13,0
吉林,2020-05-12,0,3,0,19,16,0
吉林,2020-05-16,0,2,0,19,18,0
吉林,2020-05-17,0,1,0,19,19,0
内蒙古,2020-03-24,2,0,0,2,0,0
内蒙古,2020-03-25,12,0,0,14,0,0
内蒙古,2020-03-26,3,0,0,17,0,0
内蒙古,2020-03-27,2,0,0,19,0,0
内蒙古,2020-03-28,1,0,0,20,0,0
内蒙古,2020-03-29,2,0,0,22,0,0
内蒙古,2020-03-30,10,0,0,32,0,0
内蒙古,2020-03-31,4,0,0,36,0,0
内蒙古,2020-04-01,6,0,0,42,0,0
内蒙古,2020-04-05,1,0,0,43,0,0
内蒙古,2020-04-06,3,0,0,46,0,0
内蒙古,2020-04-07,3,0,0,49,0,0
内蒙古,2020-04-08,2,5,0,51,5,0
内蒙古,2020-04-09,2,0,0,53,5,0
内蒙古,2020-04-10,27,0,0,80,5,0
内蒙古,2020-04-11,0,4,0,80,9,0
内蒙古,2020-04-12,35,0,0,115,9,0
内蒙古,2020-04-13,0,8,0,115,17,0
内蒙古,2020-04-14,0,3,0,115,20,0
内蒙古,2020-04-15,3,0,0,118,20,0
内蒙古,2020-04-16,0,9,0,118,29,0
内蒙古,2020-04-17,0,1,0,118,30,0
内蒙古,2020-04-20,0,4,0,118,34,0
内蒙古,2020-04-24,3,6,0,121,40,0
内蒙古,2020-04-25,1,7,0,122,47,0
内蒙古,2020-04-26,0,8,0,122,55,0
内蒙古,2020-04-27,1,16,0,123,71,0
内蒙古,2020-04-28,0,1,0,123,72,0
内蒙古,2020-04-29,1,4,0,124,76,0
内蒙古,2020-04-30,0,2,0,124,78,0
内蒙古,2020-05-01,0,2,0,124,80,0
内蒙古,2020-05-03,0,2,0,124,82,0
内蒙古,2020-05-04,0,4,0,124,86,0
内蒙古,2020-05-05,0,6,0,124,92,0
内蒙古,2020-05-06,0,4,0,124,96,0
内蒙古,2020-05-07,0,1,0,124,97,0
内蒙古,2020-05-08,0,3,0,124,100,0
内蒙古,2020-05-09,0,9,0,124,109,0
内蒙古,2020-05-10,7,3,0,131,112,0
内蒙古,2020-05-11,1,1,0,132,113,0
内蒙古,2020-05-12,0,2,0,132,115,0
内蒙古,2020-05-14,0,4,0,132,119,0
内蒙古,2020-05-15,0,2,0,132,121,0
内蒙古,2020-05-17,4,0,0,136,121,0
内蒙古,2020-05-18,3,0,0,139,121,0
内蒙古,2020-05-19,1,0,0,140,121,0
内蒙古,2020-05-20,0,2,0,140,123,0
内蒙古,2020-05-24,10,2,0,150,125,0
内蒙古,2020-05-25,5,3,0,155,128,0
内蒙古,2020-05-26,0,1,0,155,129,0
内蒙古,2020-05-29,0,1,0,155,130,0
内蒙古,2020-05-31,3,1,0,158,131,0
内蒙古,2020-06-01,0,2,0,158,133,0
内蒙古,2020-06-03,0,3,0,158,136,0
内蒙古,2020-06-04,0,1,0,158,137,0
内蒙古,2020-06-07,0,5,0,158,142,0
内蒙古,2020-06-08,0,8,0,158,150,0
内蒙古,2020-06-09,2,4,0,160,154,0
内蒙古,2020-06-11,0,1,0,160,155,0
内蒙古,2020-06-15,1,3,0,161,158,0
内蒙古,2020-06-20,0,1,0,161,159,0
内蒙古,2020-06-22,0,1,0,161,160,0
内蒙古,2020-06-28,0,1,0,161,161,0
湖南,2020-04-01,1,0,0,1,0,0
湖南,2020-04-17,0,1,0,1,1,0
安徽,2020-04-08,1,0,0,1,0,0
安徽,2020-04-24,0,1,0,1,1,0
辽宁,2020-04-16,1,0,0,1,0,0
辽宁,2020-05-01,0,1,0,1,1,0
